cn:sausage	cn:similarTo	cn:pudding
cn:wheat	cn:usedFor	cn:food
cn:pastry	rdfs:subClassOf	cn:food
cn:sauerbraten	rdfs:subClassOf	cn:dish
cn:lamb	rdfs:subClassOf	cn:meat
cn:visor	rdfs:subClassOf	cn:cap
cn:mercator	cn:dbpedia/product	cn:food
cn:food	cn:usedFor	cn:hunger
cn:illinois	rdfs:subClassOf	cn:state
cn:pickle	rdfs:subClassOf	cn:vegetable
cn:bread	rdfs:subClassOf	cn:usually_on_menu
cn:clavariaceae	rdfs:subClassOf	cn:fungus
cn:governorate	rdfs:subClassOf	cn:state
cn:key_chain	cn:usedFor	cn:decoration
cn:foreign_country	rdfs:subClassOf	cn:state
cn:supplì	rdfs:subClassOf	cn:food
cn:kebab	rdfs:subClassOf	cn:food
cn:scaly_lentinus	rdfs:subClassOf	cn:fungus
cn:ustilaginales	rdfs:subClassOf	cn:fungus
cn:blade	rdfs:subClassOf	cn:leaf
cn:madrilene	rdfs:subClassOf	cn:consomme
cn:strawberry	rdfs:subClassOf	cn:accessory_fruit
cn:soap	rdfs:subClassOf	cn:object
cn:mooncake	rdfs:subClassOf	cn:food
cn:green	rdfs:subClassOf	cn:colour
cn:potato_chip	rdfs:subClassOf	cn:food
cn:breadstick	rdfs:subClassOf	cn:food
cn:baguette	rdfs:subClassOf	cn:loaf_of_bread
cn:subway	cn:dbpedia/product	cn:pizza
cn:potato	rdfs:subClassOf	cn:food
cn:masala_chai	rdfs:subClassOf	cn:food
cn:fruit	cn:hasA	cn:water
cn:dave	cn:desires	cn:food
cn:kissel	cn:instanceOf	cn:dessert
cn:leaf	cn:locatedNear	cn:tree
cn:toffee	rdfs:subClassOf	cn:food
cn:hot_dog	rdfs:subClassOf	cn:sausage
cn:flatbread	cn:instanceOf	cn:bread
cn:earthtongue	rdfs:subClassOf	cn:fungus
cn:bitter_chocolate	rdfs:subClassOf	cn:chocolate
cn:bamboo_shoot	rdfs:subClassOf	cn:vegetable
cn:liquorice	rdfs:subClassOf	cn:food
cn:mafaldine	rdfs:subClassOf	cn:food
cn:ice_cream	cn:capableOf	cn:delight_child
cn:flowers	cn:hasProperty	cn:purple
cn:leafs	cn:hasProperty	cn:green
cn:submarine_sandwich	rdfs:subClassOf	cn:food
cn:cucumber	cn:partOf	cn:cucumber
cn:meat	cn:usedFor	cn:nourishment
cn:color	rdfs:subClassOf	cn:interest
cn:sauce	cn:partOf	cn:dish
cn:fruit	rdfs:subClassOf	cn:healthy_food
cn:open_face_sandwich	rdfs:subClassOf	cn:sandwich
cn:cheddar	rdfs:subClassOf	cn:cheese
cn:stratification	rdfs:subClassOf	cn:shape
cn:peas_and_onions	rdfs:subClassOf	cn:vegetables
cn:eat	cn:motivatedByGoal	cn:food
cn:bread	cn:capableOf	cn:turn_into_toast
cn:shrimp_toast	rdfs:subClassOf	cn:food
cn:pea	rdfs:subClassOf	cn:vegetable
cn:bamiyeh	rdfs:subClassOf	cn:food
cn:dish	cn:usedFor	cn:eating
cn:supplì	cn:instanceOf	cn:snack_food
cn:black_peppercorn	rdfs:subClassOf	cn:fruit
cn:camembert_cheese	rdfs:subClassOf	cn:cheese
cn:goat	cn:desires	cn:food
cn:ramekin	rdfs:subClassOf	cn:dish
cn:biscuit	rdfs:subClassOf	cn:food
cn:andouille	rdfs:subClassOf	cn:food
cn:color	rdfs:subClassOf	cn:color_perception_category
cn:tapioca	rdfs:subClassOf	cn:foodstuff
cn:rocks	cn:hasProperty	cn:solid
cn:clitocybe_nuda	rdfs:subClassOf	cn:fungus
cn:disk	cn:hasProperty	cn:circular
cn:meat	cn:usedFor	cn:baiting_traps
cn:angola	rdfs:subClassOf	cn:state
cn:food	cn:hasProperty	cn:necessary_for_survival
cn:crisphead_lettuce	rdfs:subClassOf	cn:lettuce
cn:south_carolina	rdfs:subClassOf	cn:state
cn:bannana	rdfs:subClassOf	cn:fruit
cn:moo_goo_gai_pan	rdfs:subClassOf	cn:dish
cn:rock	cn:usedFor	cn:decoration
cn:tricholoma_pessundatum	rdfs:subClassOf	cn:agaric
cn:flexion	rdfs:subClassOf	cn:living_thing
cn:salisbury_steak	rdfs:subClassOf	cn:dish
cn:toadstool	rdfs:subClassOf	cn:edible_or_inedible_mushroom
cn:heliocybe	rdfs:subClassOf	cn:fungus
cn:yogurt	rdfs:subClassOf	cn:food
cn:turn_signals	cn:hasProperty	cn:yellow
cn:cheese	rdfs:subClassOf	cn:noun
cn:eater	rdfs:subClassOf	cn:produce
cn:pasty	rdfs:subClassOf	cn:food
cn:spare_part	rdfs:subClassOf	cn:part
cn:chocolate_syrup	rdfs:subClassOf	cn:food
cn:crumb	cn:partOf	cn:baked_goods
cn:monilia	rdfs:subClassOf	cn:fungus
cn:game	rdfs:subClassOf	cn:meat
cn:chanterelle	rdfs:subClassOf	cn:spatial_thing
cn:meat	cn:usedFor	cn:animals_to_eat
cn:caramel	cn:instanceOf	cn:dessert
cn:rowanberry	rdfs:subClassOf	cn:fruit
cn:omelet	rdfs:subClassOf	cn:dish
cn:fruit	cn:usedFor	cn:producing_juice
cn:jeon	rdfs:subClassOf	cn:food
cn:ice_cream	cn:hasProperty	cn:good
cn:pome	rdfs:subClassOf	cn:fruit
cn:saccharomyces_pastorianus	rdfs:subClassOf	cn:fungus
cn:porridge	rdfs:subClassOf	cn:dish
cn:solanaceous_vegetable	rdfs:subClassOf	cn:vegetable
cn:custard	rdfs:subClassOf	cn:dish
cn:leaflet	rdfs:subClassOf	cn:leaf
cn:chilled_sweet_corn_soup	rdfs:subClassOf	cn:soup
cn:apple_strudel	rdfs:subClassOf	cn:food
cn:hamburgers	rdfs:subClassOf	cn:meat
cn:food	rdfs:subClassOf	cn:solid
cn:fruit	cn:usedFor	cn:spreading_seeds
cn:roundness	rdfs:subClassOf	cn:shape
cn:commodity	rdfs:subClassOf	cn:object
cn:ratatouille	rdfs:subClassOf	cn:food
cn:grape	rdfs:subClassOf	cn:living_thing
cn:soup	rdfs:subClassOf	cn:food_composite
cn:cocoa_butter	rdfs:subClassOf	cn:chocolate
cn:meringue	rdfs:subClassOf	cn:food
cn:candida_parapsilosis	rdfs:subClassOf	cn:fungus
cn:jersey	rdfs:subClassOf	cn:state
cn:icosahedron	rdfs:subClassOf	cn:solid
cn:cat	cn:desires	cn:food
cn:virginia_strawberry	rdfs:subClassOf	cn:strawberry
cn:having_lunch	cn:hasPrerequisite	cn:food
cn:tiger_bread	cn:instanceOf	cn:bread
cn:vinaigrette	rdfs:subClassOf	cn:food
cn:melampsora	rdfs:subClassOf	cn:fungus
cn:fruit	rdfs:subClassOf	cn:external_anatomical_part
cn:sicilian_pizza	rdfs:subClassOf	cn:pizza
cn:pizza	rdfs:subClassOf	cn:form_of_food
cn:boston_cream_pie	rdfs:subClassOf	cn:food
cn:bay_window	cn:usedFor	cn:decoration
cn:division	rdfs:subClassOf	cn:state
cn:fruitlet	rdfs:subClassOf	cn:fruit
cn:thukpa	cn:instanceOf	cn:soup
cn:fontina_cheese	rdfs:subClassOf	cn:cheese
cn:immune_thing	rdfs:subClassOf	cn:living_thing
cn:chips	rdfs:subClassOf	cn:food
cn:pillowcase	cn:usedFor	cn:decoration
cn:gumbo	rdfs:subClassOf	cn:soup
cn:cheese	cn:receivesAction	cn:found_in_store
cn:tzatziki	rdfs:subClassOf	cn:food
cn:cereal	rdfs:subClassOf	cn:food
cn:hamburger	cn:instanceOf	cn:main_course
cn:cooking_dinner	cn:hasPrerequisite	cn:food
cn:vegetables	cn:receivesAction	cn:eaten
cn:grizzled	rdfs:subClassOf	cn:color
cn:peanut_butter	rdfs:subClassOf	cn:food
cn:winter_mushroom	rdfs:subClassOf	cn:agaric
cn:yellow	rdfs:subClassOf	cn:color_assosiated_with_cowardice
cn:gouda	rdfs:subClassOf	cn:cheese
cn:monterey_jack	rdfs:subClassOf	cn:cheese
cn:lobster	rdfs:subClassOf	cn:food
cn:agaricus_arvensis	rdfs:subClassOf	cn:fungus
cn:loaf_of_bread	rdfs:subClassOf	cn:tangible_thing
cn:blushing_mushroom	rdfs:subClassOf	cn:agaric
cn:meat	rdfs:subClassOf	cn:edible_thing
cn:pea_soup	rdfs:subClassOf	cn:soup
cn:capellini	rdfs:subClassOf	cn:food
cn:marzipan	rdfs:subClassOf	cn:food
cn:pecorino_cheese	rdfs:subClassOf	cn:cheese
cn:meat	cn:usedFor	cn:meals
cn:peach	rdfs:subClassOf	cn:living_thing
cn:strawberry	cn:hasProperty	cn:rich_in_vitamin_c
cn:lactarius	rdfs:subClassOf	cn:fungus
cn:chocolate	cn:hasA	cn:sweet_taste_and_fragrance
cn:roughage	rdfs:subClassOf	cn:foodstuff
cn:animal	cn:hasA	cn:meat
cn:object	cn:capableOf	cn:fall_into_hole
cn:molten_metal	rdfs:subClassOf	cn:liquid
cn:reich	rdfs:subClassOf	cn:state
cn:vegetables	rdfs:subClassOf	cn:plants
cn:mycelium	cn:partOf	cn:fungus
cn:breakfast_food	rdfs:subClassOf	cn:food
cn:hypocreales	rdfs:subClassOf	cn:fungus
cn:saccharomyces	rdfs:subClassOf	cn:fungus
cn:pepernoot	rdfs:subClassOf	cn:food
cn:republican	cn:similarTo	cn:green
cn:irish_stew	rdfs:subClassOf	cn:food
cn:papadum	rdfs:subClassOf	cn:food
cn:star_of_bethlehem	rdfs:subClassOf	cn:object
cn:milk_of_echidna	rdfs:subClassOf	cn:pink
cn:rogue_state	rdfs:subClassOf	cn:state
cn:pear	rdfs:subClassOf	cn:fruit
cn:bread	rdfs:subClassOf	cn:cereal
cn:meat	rdfs:subClassOf	cn:animal_muscles
cn:stroopwafel	rdfs:subClassOf	cn:food
cn:erose_leaf	rdfs:subClassOf	cn:leaf
cn:cinnamon_roll	rdfs:subClassOf	cn:food
cn:pizza_crust	rdfs:subClassOf	cn:bread
cn:fungi_imperfecti	rdfs:subClassOf	cn:fungus
cn:vinegar	rdfs:subClassOf	cn:liquid
cn:tissue	rdfs:subClassOf	cn:living_thing
cn:egg_waffle	rdfs:subClassOf	cn:food
cn:food	cn:locatedNear	cn:plate
cn:raspberry	rdfs:subClassOf	cn:fruit
cn:hydnum	rdfs:subClassOf	cn:fungus
cn:fruit	rdfs:subClassOf	cn:plant_part
cn:food	cn:receivesAction	cn:sold_at_grocery_store
cn:dark_color	rdfs:subClassOf	cn:color
cn:potato_skin	rdfs:subClassOf	cn:snack_food
cn:food	rdfs:subClassOf	cn:substance
cn:green	cn:similarTo	cn:ill
cn:bear_claw	rdfs:subClassOf	cn:food
cn:cajun	rdfs:subClassOf	cn:food
cn:sukiyaki	rdfs:subClassOf	cn:food
cn:estate	cn:partOf	cn:state
cn:hamburger	cn:similarTo	cn:fish_burger
cn:escargot	rdfs:subClassOf	cn:meat
cn:rhode_island	rdfs:subClassOf	cn:state
cn:buff	cn:similarTo	cn:chromatic
cn:granny_smith_apple	rdfs:subClassOf	cn:fruit
cn:chocolate	rdfs:subClassOf	cn:candy
cn:barbecue	rdfs:subClassOf	cn:dish
cn:bread	cn:usedFor	cn:buttering
cn:ally	rdfs:subClassOf	cn:state
cn:pirog	rdfs:subClassOf	cn:food
cn:dish	rdfs:subClassOf	cn:household_furnishings
cn:kedgeree	rdfs:subClassOf	cn:dish
cn:macadamia_nut	rdfs:subClassOf	cn:fruit
cn:bosintang	rdfs:subClassOf	cn:food
cn:amber	rdfs:subClassOf	cn:yellow
cn:green_tomato	rdfs:subClassOf	cn:green
cn:manouri	rdfs:subClassOf	cn:cheese
cn:sourdough_bread	rdfs:subClassOf	cn:bread
cn:food	cn:receivesAction	cn:consumed
cn:leaf	cn:usedFor	cn:generating_energy_for_plants
cn:tiramisu	rdfs:subClassOf	cn:food
cn:stollen	rdfs:subClassOf	cn:food
cn:french_region	rdfs:subClassOf	cn:state
cn:bread_mold	rdfs:subClassOf	cn:fungus
cn:gasperone_cheese	rdfs:subClassOf	cn:cheese
cn:provolone_cheese	rdfs:subClassOf	cn:cheese
cn:whole	rdfs:subClassOf	cn:concept
cn:produce	rdfs:subClassOf	cn:raw_edibles
cn:province	rdfs:subClassOf	cn:state
cn:greek_salad	rdfs:subClassOf	cn:food
cn:whole	cn:receivesAction	cn:made_up_of_parts
cn:catfish_flesh	rdfs:subClassOf	cn:meat
cn:mozzarella	rdfs:subClassOf	cn:cheese
cn:wonton	rdfs:subClassOf	cn:food
cn:cheese	rdfs:subClassOf	cn:food_and_recipes_use_food
cn:gyromitra_esculenta	rdfs:subClassOf	cn:fungus
cn:color	cn:definedAs	cn:american_spelling_of_colour
cn:car_part	rdfs:subClassOf	cn:part
cn:peach_melba	rdfs:subClassOf	cn:dessert
cn:cocoa	rdfs:subClassOf	cn:foodstuff
cn:satay	rdfs:subClassOf	cn:food
cn:eritrea	rdfs:subClassOf	cn:state
cn:fruit	cn:capableOf	cn:grow_mold
cn:fast_food	rdfs:subClassOf	cn:nutriment
cn:tricholoma_venenata	rdfs:subClassOf	cn:agaric
cn:neapolitan_ice_cream	rdfs:subClassOf	cn:food
cn:carpet	cn:usedFor	cn:decoration
cn:additive	rdfs:subClassOf	cn:substance
cn:sherbet	rdfs:subClassOf	cn:frozen_dessert
cn:matzah_ball	rdfs:subClassOf	cn:food
cn:gas	rdfs:subClassOf	cn:substance
cn:yule_log	cn:instanceOf	cn:dessert
cn:frankfurter_bun	cn:partOf	cn:hotdog
cn:minestrone	cn:instanceOf	cn:soup
cn:terrorist_who_female	rdfs:subClassOf	cn:living_thing
cn:tomato	rdfs:subClassOf	cn:fruit
cn:cheese	rdfs:subClassOf	cn:solid_food
cn:sauce	cn:partOf	cn:pizza
cn:mars	rdfs:subClassOf	cn:food
cn:part	rdfs:subClassOf	cn:concept
cn:floating_island	rdfs:subClassOf	cn:food
cn:leaf	rdfs:subClassOf	cn:small_part_of_tree
cn:hardtack	rdfs:subClassOf	cn:food
cn:virginia	rdfs:subClassOf	cn:state
cn:cake	rdfs:subClassOf	cn:baked_goods
cn:sphere	rdfs:subClassOf	cn:object
cn:jiaozi	rdfs:subClassOf	cn:food
cn:nikujaga	cn:instanceOf	cn:soup
cn:fruit	cn:receivesAction	cn:composed_of_sections
cn:yolk	cn:hasProperty	cn:yellow
cn:pizza	rdfs:subClassOf	cn:good_food
cn:leather	cn:hasProperty	cn:solid
cn:food	cn:hasProperty	cn:important_to_health
cn:fruit	cn:usedFor	cn:allowing_trees_to_reproduce
cn:balloon	cn:usedFor	cn:decoration
cn:sausage	rdfs:subClassOf	cn:edible_thing
cn:food	cn:hasProperty	cn:necessary_to_live
cn:breadstuff	rdfs:subClassOf	cn:foodstuff
cn:round	rdfs:subClassOf	cn:shape
cn:clavicipitaceae	rdfs:subClassOf	cn:fungus
cn:vegetable	rdfs:subClassOf	cn:produce
cn:panettone	rdfs:subClassOf	cn:food
cn:unleavened_bread	rdfs:subClassOf	cn:bread
cn:varenye	cn:instanceOf	cn:dessert
cn:world_power	rdfs:subClassOf	cn:state
cn:color_of_grass	cn:hasProperty	cn:green
cn:recovered_thing	rdfs:subClassOf	cn:living_thing
cn:croquette	rdfs:subClassOf	cn:food
cn:cap	cn:receivesAction	cn:worn_on_head
cn:brownish_yellow	rdfs:subClassOf	cn:yellow
cn:rojak	rdfs:subClassOf	cn:food
cn:kumis	rdfs:subClassOf	cn:food
cn:lettuce	rdfs:subClassOf	cn:salad_green
cn:truffle	rdfs:subClassOf	cn:vegetable
cn:frog_legs	rdfs:subClassOf	cn:dish
cn:wyoming	rdfs:subClassOf	cn:state
cn:button_pink	rdfs:subClassOf	cn:pink
cn:german_state	rdfs:subClassOf	cn:state
cn:leaf	cn:usedFor	cn:paint_with
cn:parmesan_cheese	rdfs:subClassOf	cn:cheese
cn:survivor	rdfs:subClassOf	cn:living_thing
cn:empedocles	cn:dbpedia/knownFor	cn:matter
cn:leaf	cn:capableOf	cn:fall_from_tree_in_autumn
cn:runny	cn:similarTo	cn:liquid
cn:file	cn:usedFor	cn:shape
cn:wood	cn:hasProperty	cn:solid
cn:tremellaceae	rdfs:subClassOf	cn:fungus
cn:oxtail_soup	cn:instanceOf	cn:soup
cn:yellow	rdfs:subClassOf	cn:coloring
cn:coconut_milk	rdfs:subClassOf	cn:food
cn:yeast	rdfs:subClassOf	cn:fungus
cn:hot_dog	rdfs:subClassOf	cn:food
cn:earring	cn:usedFor	cn:decoration
cn:cheese_on_toast	rdfs:subClassOf	cn:food
cn:peach	rdfs:subClassOf	cn:edible_fruit
cn:peach_ice_cream	rdfs:subClassOf	cn:ice_cream
cn:bread	rdfs:subClassOf	cn:baked_goods
cn:oil	cn:hasProperty	cn:liquid
cn:red_delicious_apple	rdfs:subClassOf	cn:fruit
cn:cat_tongue	cn:instanceOf	cn:dessert
cn:halal	rdfs:subClassOf	cn:meat
cn:municipality	rdfs:subClassOf	cn:state
cn:krupuk	rdfs:subClassOf	cn:food
cn:stew	rdfs:subClassOf	cn:dish
cn:organism	cn:madeOf	cn:cells
cn:tricholoma_pardinum	rdfs:subClassOf	cn:agaric
cn:egg_white	rdfs:subClassOf	cn:ingredient
cn:jollof_rice	rdfs:subClassOf	cn:food
cn:lettuce	cn:partOf	cn:salad
cn:cucumber	rdfs:subClassOf	cn:fruit
cn:pink	rdfs:subClassOf	cn:chromatic_color
cn:salsa	rdfs:subClassOf	cn:food
cn:snails_shells	cn:hasProperty	cn:circular
cn:yellow	rdfs:subClassOf	cn:colour
cn:leaf	cn:usedFor	cn:start_new_plant
cn:tree	rdfs:subClassOf	cn:living_thing
cn:green	rdfs:subClassOf	cn:left_libertarian
cn:dandelion_green	rdfs:subClassOf	cn:leaf
cn:pepperoni	rdfs:subClassOf	cn:meat_sausage
cn:kohlrabi	rdfs:subClassOf	cn:cruciferous_vegetable
cn:wok	rdfs:subClassOf	cn:dish
cn:french_onion_soup	rdfs:subClassOf	cn:food
cn:couscous	rdfs:subClassOf	cn:food
cn:book	rdfs:subClassOf	cn:object
cn:ripe_bananas	cn:hasProperty	cn:yellow
cn:strudel	rdfs:subClassOf	cn:food
cn:oval	rdfs:subClassOf	cn:shape
cn:georgia	rdfs:subClassOf	cn:state
cn:tulostoma	rdfs:subClassOf	cn:fungus
cn:fountain	cn:usedFor	cn:decoration
cn:chocolate	cn:capableOf	cn:sweet_or_slightly_bitter
cn:biscotti	rdfs:subClassOf	cn:food
cn:stropharia_hornemannii	rdfs:subClassOf	cn:fungus
cn:ice_milk	rdfs:subClassOf	cn:food
cn:part	rdfs:subClassOf	cn:line
cn:chronic	rdfs:subClassOf	cn:living_thing
cn:angel_wings	rdfs:subClassOf	cn:food
cn:cortinarius_mutabilis	rdfs:subClassOf	cn:agaric
cn:black_rot	rdfs:subClassOf	cn:fungus
cn:takoyaki	rdfs:subClassOf	cn:food
cn:dandelion_flower	rdfs:subClassOf	cn:yellow
cn:baked_goods	rdfs:subClassOf	cn:food
cn:thing	rdfs:subClassOf	cn:substance
cn:peach	rdfs:subClassOf	cn:drupe
cn:eating	cn:hasPrerequisite	cn:food
cn:meat	cn:usedFor	cn:food
cn:coq_au_vin	rdfs:subClassOf	cn:dish
cn:lunch_meat	rdfs:subClassOf	cn:food
cn:gambia	rdfs:subClassOf	cn:state
cn:nikujaga	rdfs:subClassOf	cn:food
cn:hair	cn:usedFor	cn:decoration
cn:broccoli_rabe	rdfs:subClassOf	cn:vegetable
cn:ice_cream	cn:receivesAction	cn:considered_treat
cn:historic_welsh_county	rdfs:subClassOf	cn:state
cn:radish	rdfs:subClassOf	cn:cruciferous_vegetable
cn:paecilomyces	rdfs:subClassOf	cn:fungus
cn:bread	rdfs:subClassOf	cn:structural_element_in_sandwich
cn:leblebi	rdfs:subClassOf	cn:food
cn:brittle	rdfs:subClassOf	cn:food
cn:north_carolina	rdfs:subClassOf	cn:state
cn:sfogliatella	rdfs:subClassOf	cn:food
cn:frozen_pudding	rdfs:subClassOf	cn:frozen_dessert
cn:circular	rdfs:subClassOf	cn:shape
cn:shoestring_fungus	rdfs:subClassOf	cn:agaric
cn:matter	cn:receivesAction	cn:converted_into_energy
cn:person	cn:desires	cn:ice_cream
cn:pig's_ears	rdfs:subClassOf	cn:agaric
cn:matter	cn:madeOf	cn:elements
cn:mess	rdfs:subClassOf	cn:nutriment
cn:canada	rdfs:subClassOf	cn:state
cn:congee	rdfs:subClassOf	cn:food
cn:pears	cn:hasProperty	cn:green
cn:potato_bread	cn:instanceOf	cn:bread
cn:one_cost_of_college	rdfs:subClassOf	cn:food
cn:vasco_idiazabal	rdfs:subClassOf	cn:cheese
cn:petit_four	cn:instanceOf	cn:dessert
cn:shkedei_marak	rdfs:subClassOf	cn:food
cn:food	cn:hasProperty	cn:very_tasteful
cn:armillaria_zelleri	rdfs:subClassOf	cn:agaric
cn:fortune_cookie	rdfs:subClassOf	cn:food
cn:botswana	rdfs:subClassOf	cn:state
cn:eating_vegetables	cn:usedFor	cn:food
cn:food	cn:capableOf	cn:prevent_starvation
cn:ramalina	rdfs:subClassOf	cn:fungus
cn:buffalo_nut	rdfs:subClassOf	cn:fruit
cn:sage_green	rdfs:subClassOf	cn:green
cn:pozole	rdfs:subClassOf	cn:food
cn:kabob	rdfs:subClassOf	cn:dish
cn:pluteus_aurantiorugosus	rdfs:subClassOf	cn:agaric
cn:oregon	rdfs:subClassOf	cn:state
cn:black_soup	cn:instanceOf	cn:soup
cn:ice_cream	cn:hasA	cn:calcium
cn:tremella	rdfs:subClassOf	cn:fungus
cn:both	cn:usedFor	cn:color
cn:fruit	cn:capableOf	cn:taste_sweet
cn:trifle	rdfs:subClassOf	cn:food
cn:lollipop	rdfs:subClassOf	cn:food
cn:food	cn:receivesAction	cn:placed_on_top_of_plate
cn:paella	rdfs:subClassOf	cn:food
cn:hair_color	rdfs:subClassOf	cn:color
cn:cheese	rdfs:subClassOf	cn:popular_topping_for_potato
cn:buckthorn_berry	rdfs:subClassOf	cn:fruit
cn:calvatia_gigantea	rdfs:subClassOf	cn:fungus
cn:zone	rdfs:subClassOf	cn:state
cn:candida_albicans	rdfs:subClassOf	cn:fungus
cn:leftovers	rdfs:subClassOf	cn:food
cn:erioderma_pedicellatum	rdfs:subClassOf	cn:fungus
cn:apricot	rdfs:subClassOf	cn:fruit
cn:fruit	cn:hasProperty	cn:good_for
cn:storage_furniture	cn:usedFor	cn:decoration
cn:doll	cn:usedFor	cn:decoration
cn:chop_suey	rdfs:subClassOf	cn:dish
cn:teacake	rdfs:subClassOf	cn:food
cn:root_vegetable	rdfs:subClassOf	cn:vegetable
cn:bread	cn:hasA	cn:crust
cn:rotelle	rdfs:subClassOf	cn:food
cn:cheese	cn:hasA	cn:benign_bacteria
cn:mushroom	rdfs:subClassOf	cn:living_thing
cn:poached_egg	rdfs:subClassOf	cn:dish
cn:leaf	cn:usedFor	cn:herbivore_consumption
cn:believe_time	cn:hasProperty	cn:circular
cn:artichoke_heart	rdfs:subClassOf	cn:vegetable
cn:fish_and_chips	rdfs:subClassOf	cn:dish
cn:cheese	cn:capableOf	cn:age_to_liking
cn:sauerbraten	rdfs:subClassOf	cn:food
cn:coloring	rdfs:subClassOf	cn:foodstuff
cn:mille_feuille	rdfs:subClassOf	cn:food
cn:barmbrack	rdfs:subClassOf	cn:bread
cn:mozartkugel	rdfs:subClassOf	cn:food
cn:pink	rdfs:subClassOf	cn:color
cn:quarter_pounder	rdfs:subClassOf	cn:hamburger
cn:roll	rdfs:subClassOf	cn:small_piece_of_baked_dough
cn:haggis	rdfs:subClassOf	cn:dish
cn:acini_di_pepe	rdfs:subClassOf	cn:food
cn:stuffed_peppers	rdfs:subClassOf	cn:food
cn:boston_baked_beans	rdfs:subClassOf	cn:dish
cn:ingredient	rdfs:subClassOf	cn:foodstuff
cn:tetrazzini	rdfs:subClassOf	cn:dish
cn:vegetables	cn:receivesAction	cn:grown_in_gardens
cn:strawberry	rdfs:subClassOf	cn:sweet_red_fruit
cn:bread	cn:receivesAction	cn:made_from_flour
cn:synchytrium_endobioticum	rdfs:subClassOf	cn:fungus
cn:microsporum	rdfs:subClassOf	cn:fungus
cn:pink	rdfs:subClassOf	cn:colour_commonly
cn:food	cn:hasProperty	cn:very_pleasurable
cn:piano	cn:usedFor	cn:decoration
cn:maryland_chicken	rdfs:subClassOf	cn:dish
cn:meat	cn:usedFor	cn:clothing
cn:food	cn:receivesAction	cn:placed_on_serving_cart
cn:black	rdfs:subClassOf	cn:color
cn:arm_extended_position	rdfs:subClassOf	cn:living_thing
cn:cheese	cn:hasA	cn:flavor
cn:meat	cn:definedAs	cn:muscle_tissue_of_animals
cn:octahedron	rdfs:subClassOf	cn:solid
cn:burrito	rdfs:subClassOf	cn:assembled_food
cn:course	cn:partOf	cn:meal
cn:urine	rdfs:subClassOf	cn:yellow
cn:object	cn:partOf	cn:sentence
cn:fruit	rdfs:subClassOf	cn:gay_man
cn:carob	rdfs:subClassOf	cn:foodstuff
cn:kitchen_utensil	rdfs:subClassOf	cn:object
cn:sandwich	rdfs:subClassOf	cn:assembled_food
cn:fungus	cn:capableOf	cn:grow_on_food
cn:xylaria_polymorpha	rdfs:subClassOf	cn:fungus
cn:umbrella	cn:capableOf	cn:color
cn:botargo	rdfs:subClassOf	cn:food
cn:food	cn:hasProperty	cn:nice_to_eat
cn:zabaione	cn:instanceOf	cn:dessert
cn:gill_fungus	rdfs:subClassOf	cn:basidiomycete
cn:eating_breakfast	cn:hasPrerequisite	cn:food
cn:vegan_grilled_cheese_sandwich	rdfs:subClassOf	cn:sandwich
cn:things_with_holes	rdfs:subClassOf	cn:food
cn:scutiger	rdfs:subClassOf	cn:fungus
cn:alcohol	rdfs:subClassOf	cn:liquid
cn:stalked_puffball	rdfs:subClassOf	cn:fungus
cn:food	cn:receivesAction	cn:eaten_by_people
cn:hagberry	rdfs:subClassOf	cn:fruit
cn:tortilla	rdfs:subClassOf	cn:structural_element_in_tostada
cn:paratha	rdfs:subClassOf	cn:food
cn:osso_buco	rdfs:subClassOf	cn:dish
cn:brussels_sprouts	rdfs:subClassOf	cn:vegetables
cn:bockwurst	rdfs:subClassOf	cn:food
cn:bread	cn:usedFor	cn:drying_to_make_stuffing
cn:satisfying_appetites_with_minimum_effort	cn:hasPrerequisite	cn:food
cn:bean	rdfs:subClassOf	cn:fruit
cn:chestnut	rdfs:subClassOf	cn:fruit
cn:living_thing	rdfs:subClassOf	cn:open_system
cn:cat	cn:hasPrerequisite	cn:meat
cn:graham_bread	rdfs:subClassOf	cn:food
cn:sausage	cn:receivesAction	cn:made_from_snakes
cn:butter	rdfs:subClassOf	cn:yellow
cn:neurospora	rdfs:subClassOf	cn:fungus
cn:german_chocolate_cake	rdfs:subClassOf	cn:food
cn:pizza	rdfs:subClassOf	cn:food
cn:mcintosh_apple	rdfs:subClassOf	cn:fruit
cn:winter_salami	rdfs:subClassOf	cn:food
cn:tricholoma_aurantium	rdfs:subClassOf	cn:fungus
cn:petit_four	rdfs:subClassOf	cn:food
cn:host	rdfs:subClassOf	cn:bread
cn:cortinarius	rdfs:subClassOf	cn:fungus
cn:fiji	rdfs:subClassOf	cn:state
cn:cake	cn:usedFor	cn:dessert
cn:meat	rdfs:subClassOf	cn:not_bone
cn:food	cn:receivesAction	cn:found_in_mall
cn:chowder	rdfs:subClassOf	cn:soup
cn:bell_peppers	rdfs:subClassOf	cn:vegetables
cn:papua_new_guinea	rdfs:subClassOf	cn:state
cn:bread	rdfs:subClassOf	cn:diet_staple
cn:object	cn:hasProperty	cn:rolled_up_if_floppy
cn:circle	rdfs:subClassOf	cn:oval
cn:chocolate	cn:capableOf	cn:delight_child
cn:nepeta_cataria_leaf	rdfs:subClassOf	cn:leaf
cn:part	cn:partOf	cn:whole
cn:banana	cn:hasProperty	cn:yellow
cn:vegetables	cn:hasProperty	cn:cultivated_in_yard
cn:fruit	rdfs:subClassOf	cn:portable_object
cn:peach	cn:partOf	cn:orchard
cn:dairy_product	rdfs:subClassOf	cn:foodstuff
cn:são_paulo	rdfs:subClassOf	cn:state
cn:sausage	rdfs:subClassOf	cn:meat
cn:penicillium_chrysogenum	rdfs:subClassOf	cn:fungus
cn:sourdough	rdfs:subClassOf	cn:food
cn:limes	rdfs:subClassOf	cn:fruit
cn:liver_pudding	rdfs:subClassOf	cn:sausage
cn:gummy_bear	rdfs:subClassOf	cn:food
cn:blueberries	rdfs:subClassOf	cn:food
cn:leaf	cn:receivesAction	cn:used_by_plant_for_photosynthesis
cn:milk_chocolate	rdfs:subClassOf	cn:chocolate
cn:concavity	rdfs:subClassOf	cn:shape
cn:crop	rdfs:subClassOf	cn:living_thing
cn:sobrassada	rdfs:subClassOf	cn:food
cn:malidzano	rdfs:subClassOf	cn:food
cn:chanterelle	rdfs:subClassOf	cn:fungus
cn:gougère	rdfs:subClassOf	cn:food
cn:limes	cn:hasProperty	cn:green
cn:colour_of_lawns	cn:hasProperty	cn:green
cn:bread	cn:capableOf	cn:rise_slowly
cn:turnips	rdfs:subClassOf	cn:vegetables
cn:green_pea_soup	rdfs:subClassOf	cn:soup
cn:blancmange	rdfs:subClassOf	cn:food
cn:fruit	rdfs:subClassOf	cn:important_food_group
cn:ham_sandwich	rdfs:subClassOf	cn:sandwich
cn:frozen_dessert	cn:instanceOf	cn:dessert
cn:south_dakota	rdfs:subClassOf	cn:state
cn:pigs_in_blankets	rdfs:subClassOf	cn:food
cn:lavender	rdfs:subClassOf	cn:purple
cn:leaf	rdfs:subClassOf	cn:device_for_absorbing_light
cn:sclerotinia	rdfs:subClassOf	cn:fungus
cn:cap	rdfs:subClassOf	cn:headgear
cn:food	cn:hasProperty	cn:mexican
cn:roll	cn:similarTo	cn:b_roll
cn:purple	rdfs:subClassOf	cn:mic_of_red_and_blue
cn:peach	cn:partOf	cn:peach
cn:foie_gras	rdfs:subClassOf	cn:food
cn:cauliflower	rdfs:subClassOf	cn:cultivated_variety
cn:pizza	cn:receivesAction	cn:meant_to_cheap_food
cn:financier	rdfs:subClassOf	cn:food
cn:smut	rdfs:subClassOf	cn:fungus
cn:home_fries	rdfs:subClassOf	cn:food
cn:ice	rdfs:subClassOf	cn:frozen_dessert
cn:fluid	rdfs:subClassOf	cn:substance
cn:shoelace	rdfs:subClassOf	cn:object
cn:panuchos	rdfs:subClassOf	cn:course
cn:edible_fruit	rdfs:subClassOf	cn:produce
cn:having_party	cn:hasPrerequisite	cn:food
cn:armillaria_caligata	rdfs:subClassOf	cn:agaric
cn:salmon_flesh	rdfs:subClassOf	cn:meat
cn:liquified	cn:similarTo	cn:liquid
cn:vermicelli	rdfs:subClassOf	cn:food
cn:aphanomyces_invadans	rdfs:subClassOf	cn:fungus
cn:cross_sections_of_cylinders	cn:hasProperty	cn:circular
cn:chicken_kiev	rdfs:subClassOf	cn:food
cn:tilletia	rdfs:subClassOf	cn:fungus
cn:wynnea_americana	rdfs:subClassOf	cn:fungus
cn:afikoman	rdfs:subClassOf	cn:food
cn:both_muffins_and_celery	rdfs:subClassOf	cn:food
cn:black_forest_cake	rdfs:subClassOf	cn:food
cn:clitocybe	rdfs:subClassOf	cn:fungus
cn:three_sisiters_tomato	rdfs:subClassOf	cn:fruit
cn:pea_soup	cn:instanceOf	cn:soup
cn:sundae	cn:instanceOf	cn:dessert
cn:water	rdfs:subClassOf	cn:liquid
cn:jesse	rdfs:subClassOf	cn:living_thing
cn:pasta	rdfs:subClassOf	cn:food
cn:bittersweet_chocolate	rdfs:subClassOf	cn:chocolate
cn:true_fungus	rdfs:subClassOf	cn:fungus
cn:vegetables	rdfs:subClassOf	cn:plant_matter
cn:lantern	cn:usedFor	cn:decoration
cn:fennel	rdfs:subClassOf	cn:vegetable
cn:feeding_family	cn:hasPrerequisite	cn:food
cn:lettuce	rdfs:subClassOf	cn:raw_thing
cn:farfalle	rdfs:subClassOf	cn:food
cn:having_food	cn:hasPrerequisite	cn:food
cn:sauerkraut	rdfs:subClassOf	cn:dish
cn:ion	cn:dbpedia/product	cn:chocolate
cn:meat	cn:hasA	cn:fat
cn:raisin_bread	rdfs:subClassOf	cn:bread
cn:turtle_soup	cn:instanceOf	cn:soup
cn:triangle	rdfs:subClassOf	cn:shape
cn:sloppy_joe	rdfs:subClassOf	cn:sandwich
cn:topography	rdfs:subClassOf	cn:shape
cn:raisins	rdfs:subClassOf	cn:fruit
cn:bubble_and_squeak	rdfs:subClassOf	cn:food
cn:fårikål	rdfs:subClassOf	cn:food
cn:chocolate	rdfs:subClassOf	cn:favorite_food_of_people
cn:cloth_linen	cn:usedFor	cn:decoration
cn:american_state	rdfs:subClassOf	cn:state
cn:star	rdfs:subClassOf	cn:shape
cn:pork_pie	rdfs:subClassOf	cn:meat_pie
cn:ireland	rdfs:subClassOf	cn:state
cn:alloclavaria	rdfs:subClassOf	cn:fungus
cn:sausage	rdfs:subClassOf	cn:prepared_solid_food
cn:sushi_bento	rdfs:subClassOf	cn:course
cn:blood	rdfs:subClassOf	cn:liquid
cn:nachos	rdfs:subClassOf	cn:food
cn:biologically_viable_thing	rdfs:subClassOf	cn:living_thing
cn:sac_fungus	rdfs:subClassOf	cn:fungus
cn:chicken_marengo	rdfs:subClassOf	cn:dish
cn:loose_meat_sandwich	rdfs:subClassOf	cn:sandwich
cn:mock_turtle_soup	rdfs:subClassOf	cn:soup
cn:creature	rdfs:subClassOf	cn:living_thing
cn:aloo_gobi	rdfs:subClassOf	cn:food
cn:ergot	rdfs:subClassOf	cn:fungus
cn:matter	cn:hasProperty	cn:gaseous
cn:vichyssoise	rdfs:subClassOf	cn:soup
cn:cotton_boll	rdfs:subClassOf	cn:fruit
cn:reuben	rdfs:subClassOf	cn:sandwich
cn:brettanomyces_bruxellensis	rdfs:subClassOf	cn:fungus
cn:triangular	cn:similarTo	cn:angular
cn:jaffa_cakes	rdfs:subClassOf	cn:food
cn:collard_greens	rdfs:subClassOf	cn:vegetables
cn:yellow	rdfs:subClassOf	cn:color
cn:may_apple	rdfs:subClassOf	cn:fruit
cn:popularity	rdfs:subClassOf	cn:state
cn:pink_cloud	rdfs:subClassOf	cn:pink
cn:squash_bug	cn:hasProperty	cn:triangular
cn:frank	cn:partOf	cn:hotdog
cn:sorbet	cn:instanceOf	cn:frozen_dessert
cn:cryptococcus	rdfs:subClassOf	cn:fungus
cn:wheat_germ	rdfs:subClassOf	cn:nutriment
cn:banana_bread	rdfs:subClassOf	cn:food
cn:eyes	cn:hasProperty	cn:green
cn:belgium	rdfs:subClassOf	cn:state
cn:croque_monsieur	rdfs:subClassOf	cn:food
cn:sea_green	rdfs:subClassOf	cn:green
cn:sandwitch	rdfs:subClassOf	cn:food
cn:hollandaise_sauce	rdfs:subClassOf	cn:food
cn:egg	rdfs:subClassOf	cn:food
cn:mofongo	rdfs:subClassOf	cn:food
cn:white_castello_cheese	rdfs:subClassOf	cn:cheese
cn:chinese_cabbage	rdfs:subClassOf	cn:cabbage
cn:fruit	cn:hasProperty	cn:very_good_for_health
cn:bologna	rdfs:subClassOf	cn:sausage
cn:shade	rdfs:subClassOf	cn:color
cn:communion_wafer	rdfs:subClassOf	cn:bread
cn:yellow	rdfs:subClassOf	cn:ore
cn:kheer	rdfs:subClassOf	cn:food
cn:raw_meat	rdfs:subClassOf	cn:meat
cn:chocolate	cn:similarTo	cn:carob
cn:strawberry_ice_cream	rdfs:subClassOf	cn:ice_cream
cn:strawberry	rdfs:subClassOf	cn:plant
cn:sheet_cake	rdfs:subClassOf	cn:food
cn:panko_fried_green_tomato	rdfs:subClassOf	cn:course
cn:living_thing	rdfs:subClassOf	cn:opaque_thing
cn:nutriment	rdfs:subClassOf	cn:food
cn:fruit_salad	rdfs:subClassOf	cn:food
cn:mustard	rdfs:subClassOf	cn:cruciferous_vegetable
cn:can	cn:usedFor	cn:food
cn:male	rdfs:subClassOf	cn:living_thing
cn:guacamole	rdfs:subClassOf	cn:food
cn:bolete	rdfs:subClassOf	cn:fungus
cn:fruit	cn:capableOf	cn:decay
cn:chili	rdfs:subClassOf	cn:dish
cn:food	cn:usedFor	cn:eat
cn:dish	cn:usedFor	cn:serving_food_in
cn:food	cn:receivesAction	cn:bought_in_grocery_store
cn:cheese_spread	rdfs:subClassOf	cn:cheese
cn:fish	cn:desires	cn:food
cn:varenye	rdfs:subClassOf	cn:food
cn:prototaxites	rdfs:subClassOf	cn:fungus
cn:michigan	rdfs:subClassOf	cn:state
cn:both_radishes_and_peas	rdfs:subClassOf	cn:vegetables
cn:bottle_green	rdfs:subClassOf	cn:green
cn:perishables	rdfs:subClassOf	cn:foodstuff
cn:rio_de_janeiro	rdfs:subClassOf	cn:state
cn:cut	rdfs:subClassOf	cn:meat
cn:shortbread	rdfs:subClassOf	cn:food
cn:french_fries	cn:instanceOf	cn:snack_food
cn:ascomycota	rdfs:subClassOf	cn:fungus
cn:peas_and_onions	rdfs:subClassOf	cn:food
cn:sundae	rdfs:subClassOf	cn:food
cn:poutine	rdfs:subClassOf	cn:food
cn:vegetables	rdfs:subClassOf	cn:food
cn:earn_living	cn:motivatedByGoal	cn:food
cn:food	cn:capableOf	cn:increase_in_price
cn:hamburger	rdfs:subClassOf	cn:meat_on_bun
cn:flowers	cn:hasProperty	cn:pink
cn:beef	rdfs:subClassOf	cn:food
cn:cheese	rdfs:subClassOf	cn:aged_milk
cn:volva	cn:partOf	cn:fungus
cn:buldak	rdfs:subClassOf	cn:food
cn:couscous	rdfs:subClassOf	cn:dish
cn:food	cn:receivesAction	cn:served_on_plate
cn:beets	cn:hasProperty	cn:purple
cn:gerronema	rdfs:subClassOf	cn:fungus
cn:chanterelle	rdfs:subClassOf	cn:agaric
cn:oval	cn:hasProperty	cn:round
cn:soccer_field	cn:hasProperty	cn:green
cn:class	rdfs:subClassOf	cn:course
cn:khachapuri	rdfs:subClassOf	cn:food
cn:morchellaceae	rdfs:subClassOf	cn:fungus
cn:solid	cn:hasA	cn:strong_internal_forces
cn:margarine	rdfs:subClassOf	cn:yellow
cn:hamburger	rdfs:subClassOf	cn:meat_has
cn:meat	cn:receivesAction	cn:put_into_cold_storage
cn:pot_au_feu	rdfs:subClassOf	cn:food
cn:chocolate	rdfs:subClassOf	cn:flavour_for_food
cn:tutti_frutti	rdfs:subClassOf	cn:ice_cream
cn:mineral	rdfs:subClassOf	cn:solid
cn:flask	cn:hasA	cn:liquid
cn:pizza	cn:hasProperty	cn:popular
cn:sheep_flesh	rdfs:subClassOf	cn:meat
cn:bisque	rdfs:subClassOf	cn:food
cn:cavatelli	rdfs:subClassOf	cn:food
cn:liederkranz	rdfs:subClassOf	cn:cheese
cn:kho	rdfs:subClassOf	cn:food
cn:tunaburger	rdfs:subClassOf	cn:sandwich
cn:won_ton	rdfs:subClassOf	cn:soup
cn:hoe	rdfs:subClassOf	cn:food
cn:buildings	cn:hasProperty	cn:solid
cn:bird's_nest_fungus	rdfs:subClassOf	cn:fungus
cn:fruit	rdfs:subClassOf	cn:source_of_vitamin_c
cn:small_children	cn:desires	cn:color
cn:potpie	rdfs:subClassOf	cn:dish
cn:saucer	rdfs:subClassOf	cn:dish
cn:chicken_meat	rdfs:subClassOf	cn:meat
cn:feather	cn:usedFor	cn:decoration
cn:melon	rdfs:subClassOf	cn:fruit
cn:garden_lettuce	rdfs:subClassOf	cn:lettuce
cn:ringworm	rdfs:subClassOf	cn:fungus
cn:gherkin	rdfs:subClassOf	cn:cucumber
cn:hot_and_sour_soup	rdfs:subClassOf	cn:food
cn:food	cn:hasProperty	cn:solid_or_liquid
cn:argentina	rdfs:subClassOf	cn:state
cn:eating_lunch	cn:hasPrerequisite	cn:food
cn:alabama	rdfs:subClassOf	cn:state
cn:part	cn:partOf	cn:hair
cn:leaf	cn:usedFor	cn:budding_in_spring
cn:chlorophyllum_molybdites	rdfs:subClassOf	cn:agaric
cn:cannoli	rdfs:subClassOf	cn:food
cn:food	cn:usedFor	cn:sustenance
cn:chicken_sandwich	rdfs:subClassOf	cn:food
cn:sausage	cn:usedFor	cn:food
cn:adobo	rdfs:subClassOf	cn:dish
cn:fly_agaric	rdfs:subClassOf	cn:toadstool
cn:phallus_impudicus	rdfs:subClassOf	cn:fungus
cn:sandwich	rdfs:subClassOf	cn:food
cn:injera	rdfs:subClassOf	cn:food
cn:tortilla	cn:madeOf	cn:corn_or_flour
cn:anellini	rdfs:subClassOf	cn:food
cn:chewing_gum	rdfs:subClassOf	cn:food
cn:meat_loaf	rdfs:subClassOf	cn:loaf_of_bread
cn:pâté	rdfs:subClassOf	cn:food
cn:angular	cn:similarTo	cn:triangular
cn:sandwich	rdfs:subClassOf	cn:prepared_solid_food
cn:potato_salad	rdfs:subClassOf	cn:food
cn:corncob	cn:hasProperty	cn:yellow
cn:patty_melt	rdfs:subClassOf	cn:sandwich
cn:cauliflower	rdfs:subClassOf	cn:crucifer
cn:gourd	rdfs:subClassOf	cn:fruit
cn:christmas_pudding	rdfs:subClassOf	cn:food
cn:scutula	rdfs:subClassOf	cn:fungus
cn:hericium_erinaceus	rdfs:subClassOf	cn:fungus
cn:bun	rdfs:subClassOf	cn:roll
cn:runcinate_leaf	rdfs:subClassOf	cn:leaf
cn:burrito	rdfs:subClassOf	cn:dish
cn:foodstuff	rdfs:subClassOf	cn:food
cn:ice_cream	rdfs:subClassOf	cn:frozen_food
cn:food	cn:usedFor	cn:energy
cn:white_rust	rdfs:subClassOf	cn:fungus
cn:taco	rdfs:subClassOf	cn:food
cn:cabbage	rdfs:subClassOf	cn:cruciferous_vegetable
cn:cherry_tomato	rdfs:subClassOf	cn:fruit
cn:olive_green	rdfs:subClassOf	cn:green
cn:cortinarius_gentilis	rdfs:subClassOf	cn:agaric
cn:albatrellus_ovinus	rdfs:subClassOf	cn:fungus
cn:fruit	cn:hasProperty	cn:colorful
cn:purple	cn:hasA	cn:shorter_wavelength_than_red
cn:kenya	rdfs:subClassOf	cn:state
cn:bahamas	rdfs:subClassOf	cn:state
cn:pavlova	rdfs:subClassOf	cn:dessert
cn:food	cn:capableOf	cn:go_rotten
cn:at_risk	rdfs:subClassOf	cn:living_thing
cn:leaf	cn:usedFor	cn:making_oxygen_from_carbon_dioxide
cn:object	cn:capableOf	cn:become_broken
cn:hummus	rdfs:subClassOf	cn:food
cn:royal_icing	rdfs:subClassOf	cn:food
cn:course	rdfs:subClassOf	cn:nutriment
cn:oligoporus	rdfs:subClassOf	cn:fungus
cn:banana	rdfs:subClassOf	cn:yellow
cn:cuboid	rdfs:subClassOf	cn:parallelepiped
cn:pepperoni	rdfs:subClassOf	cn:sausage
cn:onions	cn:hasProperty	cn:green
cn:child	cn:desires	cn:ice_cream
cn:toadstool	rdfs:subClassOf	cn:agaric
cn:casserole	rdfs:subClassOf	cn:dish
cn:sporophyll	rdfs:subClassOf	cn:leaf
cn:door	cn:hasProperty	cn:solid
cn:coprinus	rdfs:subClassOf	cn:fungus
cn:clitocybe_irina	rdfs:subClassOf	cn:agaric
cn:object	cn:capableOf	cn:doing_verb
cn:cucumber	rdfs:subClassOf	cn:vegetable
cn:both_cabbage_and_tomatoes	rdfs:subClassOf	cn:food
cn:turnip	rdfs:subClassOf	cn:cruciferous_vegetable
cn:staying_healthy	cn:hasPrerequisite	cn:food
cn:crabmeat	rdfs:subClassOf	cn:meat
cn:beef_stroganoff	rdfs:subClassOf	cn:food
cn:tteok	rdfs:subClassOf	cn:food
cn:food	cn:hasProperty	cn:fried_in_wok
cn:crème_brûlée	cn:instanceOf	cn:dessert
cn:quesadilla	rdfs:subClassOf	cn:food
cn:barbecued_wing	rdfs:subClassOf	cn:dish
cn:both_salad_and_pizza	rdfs:subClassOf	cn:food
cn:cabbage	cn:partOf	cn:cabbage
cn:glass	rdfs:subClassOf	cn:solid
cn:mildew	rdfs:subClassOf	cn:fungus
cn:antidoron	cn:instanceOf	cn:bread
cn:butter_tea	rdfs:subClassOf	cn:food
cn:color	cn:capableOf	cn:marry_another_color
cn:chapati	rdfs:subClassOf	cn:food
cn:lettuce	cn:madeOf	cn:water
cn:pad_thai	rdfs:subClassOf	cn:food
cn:zakuski	rdfs:subClassOf	cn:food
cn:dashi	cn:instanceOf	cn:soup
cn:state	rdfs:subClassOf	cn:position_within_system
cn:escalope_de_veau_orloff	rdfs:subClassOf	cn:dish
cn:sandwich_plate	rdfs:subClassOf	cn:dish
cn:floral_leaf	rdfs:subClassOf	cn:leaf
cn:chocolate_liquor	rdfs:subClassOf	cn:chocolate
cn:wild_strawberry	rdfs:subClassOf	cn:strawberry
cn:purple	rdfs:subClassOf	cn:color
cn:bread	rdfs:subClassOf	cn:commonly
cn:rutabagas	rdfs:subClassOf	cn:vegetables
cn:strawberry	rdfs:subClassOf	cn:berry
cn:ham_hock	rdfs:subClassOf	cn:food
cn:sauerkraut	rdfs:subClassOf	cn:cabbage
cn:egg	cn:usedFor	cn:food
cn:cheese	cn:hasProperty	cn:good_when_people_like
cn:rabbit	cn:desires	cn:lettuce
cn:strawberry	rdfs:subClassOf	cn:birthmark
cn:liptauer	rdfs:subClassOf	cn:food
cn:fabada_asturiana	rdfs:subClassOf	cn:food
cn:food	rdfs:subClassOf	cn:not
cn:green_smut_fungus	rdfs:subClassOf	cn:fungus
cn:vegetables	cn:receivesAction	cn:grown_to_use_for_food
cn:liquid	cn:hasProperty	cn:necessary_for_swimming
cn:santa_hat	rdfs:subClassOf	cn:cap
cn:pizza	rdfs:subClassOf	cn:dish
cn:vegetarian_sausage	rdfs:subClassOf	cn:sausage
cn:turkey_meat	rdfs:subClassOf	cn:meat
cn:okroshka	cn:instanceOf	cn:soup
cn:tarator	cn:instanceOf	cn:soup
cn:vegetables	cn:hasProperty	cn:good_for
cn:baking_oven	cn:usedFor	cn:pizza
cn:chanterelle	rdfs:subClassOf	cn:edible_mushroom
cn:dish	cn:receivesAction	cn:served
cn:curvature	rdfs:subClassOf	cn:shape
cn:vegetables	cn:receivesAction	cn:steamed
cn:chipolata	rdfs:subClassOf	cn:sausage
cn:yassa	rdfs:subClassOf	cn:food
cn:pears	rdfs:subClassOf	cn:food
cn:split	rdfs:subClassOf	cn:frozen_dessert
cn:hand_cheese	rdfs:subClassOf	cn:cheese
cn:prune	rdfs:subClassOf	cn:living_thing
cn:liquid	cn:similarTo	cn:solid
cn:royal_agaric	rdfs:subClassOf	cn:agaric
cn:flowers	cn:hasProperty	cn:yellow
cn:tortellini	rdfs:subClassOf	cn:food
cn:whole	cn:madeOf	cn:parts
cn:burger	rdfs:subClassOf	cn:sandwich
cn:turkey	rdfs:subClassOf	cn:food
cn:croquette	rdfs:subClassOf	cn:dish
cn:pythium	rdfs:subClassOf	cn:fungus
cn:food	rdfs:subClassOf	cn:good
cn:chicken_provencale	rdfs:subClassOf	cn:dish
cn:pierogi	rdfs:subClassOf	cn:food
cn:stilton	rdfs:subClassOf	cn:cheese
cn:marasca	rdfs:subClassOf	cn:fruit
cn:food	cn:hasProperty	cn:nourishing
cn:tapioca_pudding	rdfs:subClassOf	cn:food
cn:ink_in_pens	cn:hasProperty	cn:green
cn:crust	cn:partOf	cn:pizza
cn:pizza	cn:hasA	cn:mostly_dough_cheese_and_tomato
cn:club_sandwich	rdfs:subClassOf	cn:sandwich
cn:entire_leaf	rdfs:subClassOf	cn:leaf
cn:glasses_case	cn:usedFor	cn:decoration
cn:korean_cuisine	rdfs:subClassOf	cn:food
cn:nectarine	rdfs:subClassOf	cn:fruit
cn:dark_meat	rdfs:subClassOf	cn:meat
cn:white_currant	rdfs:subClassOf	cn:living_thing
cn:headcheese	rdfs:subClassOf	cn:sausage
cn:chocolate	cn:hasA	cn:lot_of_fat
cn:flatbread	rdfs:subClassOf	cn:bread
cn:meat	rdfs:subClassOf	cn:commonly
cn:fritter	rdfs:subClassOf	cn:food
cn:roulade	rdfs:subClassOf	cn:dish
cn:sprinkles	rdfs:subClassOf	cn:food
cn:zwieback	rdfs:subClassOf	cn:bread
cn:hamburger	cn:receivesAction	cn:ground_up_dead_cows
cn:grenada	rdfs:subClassOf	cn:state
cn:yellow_mustard	rdfs:subClassOf	cn:yellow
cn:ethiopia	rdfs:subClassOf	cn:state
cn:tamagoyaki	rdfs:subClassOf	cn:food
cn:pizza	rdfs:subClassOf	cn:disc_shaped_food_item
cn:suzerain	rdfs:subClassOf	cn:state
cn:sachertorte	rdfs:subClassOf	cn:food
cn:goose	rdfs:subClassOf	cn:meat
cn:food	cn:receivesAction	cn:edible
cn:sausage	cn:similarTo	cn:kishka
cn:heather_mixture	rdfs:subClassOf	cn:color
cn:samosa	rdfs:subClassOf	cn:food
cn:parfait	rdfs:subClassOf	cn:frozen_dessert
cn:state	rdfs:subClassOf	cn:point_within_system
cn:cracked_wheat_bread	rdfs:subClassOf	cn:bread
cn:clock	cn:usedFor	cn:decoration
cn:meat_sausage	rdfs:subClassOf	cn:meat
cn:liquid	cn:createdBy	cn:melting_solid
cn:orange_yellow	rdfs:subClassOf	cn:yellow
cn:state	rdfs:subClassOf	cn:political_entity
cn:ramen	rdfs:subClassOf	cn:soup
cn:course	rdfs:subClassOf	cn:ready_to_eat_food
cn:highlighter_pen	cn:hasProperty	cn:yellow
cn:doormat	cn:usedFor	cn:decoration
cn:pizza	rdfs:subClassOf	cn:fast_food
cn:nephroma	rdfs:subClassOf	cn:fungus
cn:fruit	rdfs:subClassOf	cn:good_snack
cn:food	cn:receivesAction	cn:stored_in_pantry
cn:quark_cheese	rdfs:subClassOf	cn:cheese
cn:dish	rdfs:subClassOf	cn:plate
cn:pizza	rdfs:subClassOf	cn:favorite_food_of_many
cn:trash	rdfs:subClassOf	cn:object
cn:object	cn:capableOf	cn:belong_to_person
cn:braunschweiger	cn:instanceOf	cn:sausage
cn:ranch_dressing	rdfs:subClassOf	cn:food
cn:leaf	cn:usedFor	cn:capturing_sunlight_and_plant_respiration
cn:nauru	rdfs:subClassOf	cn:state
cn:cold_cuts	rdfs:subClassOf	cn:meat
cn:bread	rdfs:subClassOf	cn:finger_food
cn:blancmange	cn:instanceOf	cn:dessert
cn:mug	rdfs:subClassOf	cn:dish
cn:piece	cn:partOf	cn:whole
cn:heart	rdfs:subClassOf	cn:shape
cn:mutton	rdfs:subClassOf	cn:meat
cn:egg_tart	rdfs:subClassOf	cn:food
cn:yellow	rdfs:subClassOf	cn:chromatic_color
cn:quick_bread	rdfs:subClassOf	cn:bread
cn:chaat	rdfs:subClassOf	cn:food
cn:lekvar	rdfs:subClassOf	cn:food
cn:yule_log	rdfs:subClassOf	cn:food
cn:fungal_agent	rdfs:subClassOf	cn:fungus
cn:food	rdfs:subClassOf	cn:smaller_than_animal_eating
cn:non_spectral_color	rdfs:subClassOf	cn:color
cn:verticillium	rdfs:subClassOf	cn:fungus
cn:duck	rdfs:subClassOf	cn:meat
cn:living_thing	rdfs:subClassOf	cn:living_or_fictional_thing
cn:baked_alaska	cn:instanceOf	cn:dessert
cn:cheese_sandwich	rdfs:subClassOf	cn:sandwich
cn:fireplace	cn:usedFor	cn:decoration
cn:chocolate	rdfs:subClassOf	cn:composite_edible_substance
cn:find_underground	rdfs:subClassOf	cn:fungus
cn:tool	rdfs:subClassOf	cn:object
cn:mulligatawny	rdfs:subClassOf	cn:soup
cn:volvaria_bombycina	rdfs:subClassOf	cn:fungus
cn:soufflé	rdfs:subClassOf	cn:food
cn:boletus	rdfs:subClassOf	cn:fungus
cn:fruit	cn:usedFor	cn:paring
cn:kulcha	rdfs:subClassOf	cn:food
cn:yellow	rdfs:subClassOf	cn:colored_thing
cn:ribbon	cn:capableOf	cn:color
cn:grass_jelly	rdfs:subClassOf	cn:food
cn:cullen_skink	rdfs:subClassOf	cn:food
cn:fettuccine	rdfs:subClassOf	cn:food
cn:glomus	rdfs:subClassOf	cn:fungus
cn:ice_cream	rdfs:subClassOf	cn:good_dessert_item
cn:state	cn:hasA	cn:political_leaders
cn:pork	rdfs:subClassOf	cn:meat
cn:petrol	rdfs:subClassOf	cn:liquid
cn:pholiota	rdfs:subClassOf	cn:fungus
cn:burrito	rdfs:subClassOf	cn:prepared_solid_food
cn:meat	rdfs:subClassOf	cn:flesh
cn:peach	rdfs:subClassOf	cn:plant
cn:fruit	rdfs:subClassOf	cn:rarely
cn:annin_tofu	rdfs:subClassOf	cn:food
cn:carrot_cake	rdfs:subClassOf	cn:food
cn:brunswick_stew	rdfs:subClassOf	cn:food
cn:broccoli_and_beans	rdfs:subClassOf	cn:food
cn:chili_dog	rdfs:subClassOf	cn:hotdog
cn:front_garden	cn:usedFor	cn:decoration
cn:capirotada	rdfs:subClassOf	cn:food
cn:emerald	cn:hasProperty	cn:green
cn:dessert	rdfs:subClassOf	cn:food
cn:green	cn:definedAs	cn:colour_of_envy
cn:maiden_pink	rdfs:subClassOf	cn:pink
cn:fruit	cn:createdBy	cn:plants
cn:chutney	rdfs:subClassOf	cn:food
cn:maine	rdfs:subClassOf	cn:state
cn:leaf	cn:usedFor	cn:collecting_nutrients_for_plant
cn:thing	rdfs:subClassOf	cn:object
cn:asexual_organism	rdfs:subClassOf	cn:living_thing
cn:grass_broccoli_and_many_other_plants	cn:hasProperty	cn:green
cn:cooking_oil	rdfs:subClassOf	cn:yellow
cn:eggplant	cn:hasProperty	cn:purple
cn:ice_cream	cn:capableOf	cn:melt
cn:fruit	rdfs:subClassOf	cn:part_of_plant
cn:food	cn:capableOf	cn:cost_lot
cn:mustard	cn:hasProperty	cn:yellow
cn:taco	rdfs:subClassOf	cn:dish
cn:matter	cn:madeOf	cn:particles
cn:yellow_peppers	rdfs:subClassOf	cn:vegetables
cn:ottoman	cn:usedFor	cn:decoration
cn:dish	cn:usedFor	cn:cooking
cn:trichophyton	rdfs:subClassOf	cn:fungus
cn:ground_beef	cn:partOf	cn:hamburger
cn:drink	rdfs:subClassOf	cn:liquid
cn:viand	rdfs:subClassOf	cn:dish
cn:hamburger	cn:receivesAction	cn:made_from_animal_flesh
cn:coral	rdfs:subClassOf	cn:pink
cn:food	cn:capableOf	cn:taste_salty
cn:chicken	rdfs:subClassOf	cn:meat
cn:russian_state	rdfs:subClassOf	cn:state
cn:morbier_cheese	rdfs:subClassOf	cn:cheese
cn:scrambled_egg	rdfs:subClassOf	cn:dish
cn:spinach	rdfs:subClassOf	cn:vegetable
cn:slider	rdfs:subClassOf	cn:hamburger
cn:hamburger	cn:receivesAction	cn:ground_up_beef
cn:sausage	cn:similarTo	cn:allantois
cn:religieuse	rdfs:subClassOf	cn:food
cn:chartreuse	rdfs:subClassOf	cn:color
cn:leaf	cn:usedFor	cn:eat_if_leaf_eatable
cn:crêpe	rdfs:subClassOf	cn:food
cn:salt_rising_bread	rdfs:subClassOf	cn:bread
cn:sinseollo	rdfs:subClassOf	cn:food
cn:food	rdfs:subClassOf	cn:part_of_nation's_culture
cn:oval	rdfs:subClassOf	cn:figure
cn:organic_chicken	rdfs:subClassOf	cn:course
cn:welsh_rarebit	rdfs:subClassOf	cn:dish
cn:peach	rdfs:subClassOf	cn:stone_fruit
cn:fistulina_hepatica	rdfs:subClassOf	cn:fungus
cn:ice_pop	rdfs:subClassOf	cn:food
cn:carrots	rdfs:subClassOf	cn:food
cn:green_bean	rdfs:subClassOf	cn:vegetable
cn:beret	rdfs:subClassOf	cn:cap
cn:dish	cn:partOf	cn:meal
cn:almond	rdfs:subClassOf	cn:fruit
cn:ornatifilum	rdfs:subClassOf	cn:fungus
cn:chocolate	cn:partOf	cn:cacao
cn:vetkoek	rdfs:subClassOf	cn:food
cn:cap	rdfs:subClassOf	cn:plant_part
cn:clitocybe_dealbata	rdfs:subClassOf	cn:agaric
cn:projectile	rdfs:subClassOf	cn:object
cn:cheese	rdfs:subClassOf	cn:ingredient_in_nachos
cn:veal_parmesan	rdfs:subClassOf	cn:dish
cn:muffuletta	rdfs:subClassOf	cn:food
cn:methanogen	rdfs:subClassOf	cn:organism
cn:zrazy	rdfs:subClassOf	cn:food
cn:primary_colour	rdfs:subClassOf	cn:color
cn:naan	rdfs:subClassOf	cn:food
cn:bread	cn:usedFor	cn:eating
cn:pringles	rdfs:subClassOf	cn:food
cn:peach	cn:hasA	cn:pit
cn:stick_of_butter	cn:hasProperty	cn:yellow
cn:sudanese_state	rdfs:subClassOf	cn:state
cn:torus	rdfs:subClassOf	cn:object
cn:gloeophyllum_sepiarium	rdfs:subClassOf	cn:fungus
cn:bagna_càuda	rdfs:subClassOf	cn:food
cn:brick_cheese	rdfs:subClassOf	cn:cheese
cn:food	cn:capableOf	cn:provide_comfort
cn:blancmange	rdfs:subClassOf	cn:dessert
cn:shchi	cn:instanceOf	cn:soup
cn:dish	cn:usedFor	cn:eat_pudding
cn:ice_cream	cn:hasProperty	cn:served_cold
cn:twinkie	rdfs:subClassOf	cn:food
cn:cortinarius_corrugatus	rdfs:subClassOf	cn:agaric
cn:cocoa_pod	rdfs:subClassOf	cn:fruit
cn:meat_pie	rdfs:subClassOf	cn:pie
cn:color	cn:usedFor	cn:attraction
cn:suprême_sauce	rdfs:subClassOf	cn:food
cn:color	rdfs:subClassOf	cn:property_of_wallpaper
cn:tiramisu	cn:instanceOf	cn:dessert
cn:eggs_benedict	rdfs:subClassOf	cn:dish
cn:mastigomycotina	rdfs:subClassOf	cn:fungus
cn:scallopine	rdfs:subClassOf	cn:dish
cn:carnation	rdfs:subClassOf	cn:pink
cn:getting_wet	cn:hasPrerequisite	cn:liquid
cn:food	cn:receivesAction	cn:eaten_for_nourishment
cn:turtle_soup	rdfs:subClassOf	cn:soup
cn:cullen_skink	rdfs:subClassOf	cn:soup
cn:terrace	cn:usedFor	cn:decoration
cn:cendol	cn:instanceOf	cn:dessert
cn:fruit	cn:hasProperty	cn:very_healthy_to_eat
cn:velveeta	rdfs:subClassOf	cn:cheese
cn:tomato_paste	rdfs:subClassOf	cn:ingredient
cn:mititei	rdfs:subClassOf	cn:food
cn:namibia	rdfs:subClassOf	cn:state
cn:shrimp_flesh	rdfs:subClassOf	cn:meat
cn:kiwifruit	rdfs:subClassOf	cn:fruit
cn:kiwi	rdfs:subClassOf	cn:fruit
cn:state	rdfs:subClassOf	cn:political_unit
cn:urinating	cn:hasPrerequisite	cn:liquid
cn:butter	cn:hasProperty	cn:yellow
cn:mammal_meat	rdfs:subClassOf	cn:meat
cn:veal_cordon_bleu	rdfs:subClassOf	cn:dish
cn:curry_puff	rdfs:subClassOf	cn:food
cn:state	rdfs:subClassOf	cn:administrative_district
cn:pregnant_woman	rdfs:subClassOf	cn:living_thing
cn:meat	cn:receivesAction	cn:found_in_animals
cn:bánh_xèo	rdfs:subClassOf	cn:food
cn:sausage	cn:madeOf	cn:meat
cn:leaf_lettuce	rdfs:subClassOf	cn:lettuce
cn:fruit	cn:usedFor	cn:making_pie
cn:frikadeller	rdfs:subClassOf	cn:food
cn:canadian_province	rdfs:subClassOf	cn:state
cn:island_group	rdfs:subClassOf	cn:state
cn:ice_lolly	rdfs:subClassOf	cn:frozen_dessert
cn:wine	cn:madeOf	cn:fruit
cn:apples_and_bananas	rdfs:subClassOf	cn:fruit
cn:living_thing	rdfs:subClassOf	cn:organic_matter
cn:snowflake	cn:usedFor	cn:decoration
cn:contumyces	rdfs:subClassOf	cn:fungus
cn:wrap	rdfs:subClassOf	cn:sandwich
cn:red_meat	rdfs:subClassOf	cn:meat
cn:food	rdfs:subClassOf	cn:often_selected
cn:chili_relleno	rdfs:subClassOf	cn:course
cn:burrito	rdfs:subClassOf	cn:ready_to_eat_food
cn:idaho	rdfs:subClassOf	cn:state
cn:russulaceae	rdfs:subClassOf	cn:fungus
cn:dish	rdfs:subClassOf	cn:plate_of_food
cn:lemon	rdfs:subClassOf	cn:fruit
cn:pickle	rdfs:subClassOf	cn:cucumber
cn:parsnips	rdfs:subClassOf	cn:vegetables
cn:stinky_tofu	rdfs:subClassOf	cn:food
cn:entoloma	rdfs:subClassOf	cn:fungus
cn:cordyceps	rdfs:subClassOf	cn:fungus
cn:platter	rdfs:subClassOf	cn:dish
cn:grain	rdfs:subClassOf	cn:foodstuff
cn:plums	rdfs:subClassOf	cn:fruit
cn:mango	rdfs:subClassOf	cn:fruit
cn:cereal_bowl	rdfs:subClassOf	cn:dish
cn:coquilles_saint_jacques	rdfs:subClassOf	cn:dish
cn:tarte_flambée	rdfs:subClassOf	cn:food
cn:pineapple_cake	rdfs:subClassOf	cn:food
cn:rigatoni	rdfs:subClassOf	cn:food
cn:pineapple	rdfs:subClassOf	cn:fruit
cn:state	rdfs:subClassOf	cn:first_order_administrative_division
cn:geastrum	rdfs:subClassOf	cn:fungus
cn:embryo	rdfs:subClassOf	cn:organism
cn:food	cn:receivesAction	cn:grown_in_rural_areas
cn:josef_albers	cn:dbpedia/field	cn:color
cn:colour_of_hay	cn:hasProperty	cn:yellow
cn:chanterelle	cn:dbpedia/genus	cn:cantharellus
cn:asparagus	rdfs:subClassOf	cn:vegetable
cn:convexity	rdfs:subClassOf	cn:shape
cn:cheese	cn:capableOf	cn:age_well
cn:gyro	rdfs:subClassOf	cn:sandwich
cn:bbq	rdfs:subClassOf	cn:food
cn:tortillas	cn:hasProperty	cn:circular
cn:spaghetti_squash	rdfs:subClassOf	cn:vegetables
cn:greenery	rdfs:subClassOf	cn:leaf
cn:food	cn:receivesAction	cn:bought_in_mall
cn:banana_sandwich	rdfs:subClassOf	cn:sandwich
cn:concoction	rdfs:subClassOf	cn:foodstuff
cn:quarter	rdfs:subClassOf	cn:state
cn:bagel	rdfs:subClassOf	cn:food
cn:leaf	cn:usedFor	cn:making_food_for_tree
cn:buffalo_wing	rdfs:subClassOf	cn:dish
cn:onion_ring	rdfs:subClassOf	cn:food
cn:pezizales	rdfs:subClassOf	cn:fungus
cn:pound_cake	rdfs:subClassOf	cn:food
cn:liquid	cn:capableOf	cn:flow
cn:bread	cn:capableOf	cn:get_stale
cn:gumbo	rdfs:subClassOf	cn:vegetable
cn:unripe_banana_peels	cn:hasProperty	cn:green
cn:squash	rdfs:subClassOf	cn:vegetable
cn:pakistan	rdfs:subClassOf	cn:state
cn:pastry	rdfs:subClassOf	cn:dessert
cn:paska	rdfs:subClassOf	cn:food
cn:farmland	cn:partOf	cn:state
cn:papaya	rdfs:subClassOf	cn:fruit
cn:boule	cn:instanceOf	cn:bread
cn:czech_republic	rdfs:subClassOf	cn:state
cn:banku	rdfs:subClassOf	cn:food
cn:ice_cream	cn:hasA	cn:sugar_which_sweet
cn:swedes_carrots_potatoes_and_aubergines	rdfs:subClassOf	cn:vegetables
cn:soup	rdfs:subClassOf	cn:dish
cn:ruminant_flesh	rdfs:subClassOf	cn:meat
cn:mercury	rdfs:subClassOf	cn:liquid
cn:in_remission_thing	rdfs:subClassOf	cn:living_thing
cn:ice_cream	rdfs:subClassOf	cn:dairy_product
cn:object	cn:capableOf	cn:gain_speed
cn:matter	cn:capableOf	cn:exert_force_on_other_matter
cn:leaf	cn:capableOf	cn:photosynthesizing
cn:daisies	cn:hasProperty	cn:yellow
cn:radiigera_fuscogleba	rdfs:subClassOf	cn:fungus
cn:soviet_socialist_republic	rdfs:subClassOf	cn:state
cn:tremellales	rdfs:subClassOf	cn:fungus
cn:sesame_fruit	rdfs:subClassOf	cn:fruit
cn:tortilla	rdfs:subClassOf	cn:food
cn:grapes	cn:hasProperty	cn:green
cn:salad	rdfs:subClassOf	cn:food
cn:kiribati	rdfs:subClassOf	cn:state
cn:food	cn:hasProperty	cn:spicy_hot
cn:meat	cn:usedFor	cn:waiters_to_serve
cn:circle	rdfs:subClassOf	cn:shape
cn:tables	cn:hasProperty	cn:oval
cn:leccinum	rdfs:subClassOf	cn:fungus
cn:yellow	rdfs:subClassOf	cn:chromatic
cn:broccoli_rabe	rdfs:subClassOf	cn:cruciferous_vegetable
cn:cortinarius_armillatus	rdfs:subClassOf	cn:agaric
cn:pepperoni	rdfs:subClassOf	cn:food
cn:bread	cn:capableOf	cn:rise_in_oven
cn:cheesecake	cn:instanceOf	cn:dessert
cn:hot_chicken	rdfs:subClassOf	cn:food
cn:green	rdfs:subClassOf	cn:color
cn:vegetables	cn:capableOf	cn:cost_more_in_winter
cn:object	rdfs:subClassOf	cn:composite_type
cn:special	rdfs:subClassOf	cn:dish
cn:coquille	rdfs:subClassOf	cn:dish
cn:department	rdfs:subClassOf	cn:state
cn:color	rdfs:subClassOf	cn:greeks
cn:west_virginia	rdfs:subClassOf	cn:state
cn:pannekoek	rdfs:subClassOf	cn:food
cn:frozen_custard	rdfs:subClassOf	cn:food
cn:seafood	rdfs:subClassOf	cn:meat
cn:dulce_de_leche	rdfs:subClassOf	cn:food
cn:pepperoni_pizza	rdfs:subClassOf	cn:pizza
cn:malaysia	rdfs:subClassOf	cn:state
cn:food	cn:usedFor	cn:pleasure
cn:deer_flesh	rdfs:subClassOf	cn:meat
cn:banana	rdfs:subClassOf	cn:dessert
cn:chicken_kiev	rdfs:subClassOf	cn:dish
cn:slop	rdfs:subClassOf	cn:food
cn:submarine_sandwich	rdfs:subClassOf	cn:sandwich
cn:peanut_butter_sandwich	rdfs:subClassOf	cn:sandwich
cn:bakso	rdfs:subClassOf	cn:food
cn:slatko	cn:instanceOf	cn:dessert
cn:food	cn:capableOf	cn:cooked_or_uncooked
cn:flavorer	rdfs:subClassOf	cn:ingredient
cn:leaf	cn:partOf	cn:flowers
cn:magiritsa	cn:instanceOf	cn:soup
cn:gasteromycete	rdfs:subClassOf	cn:fungus
cn:eat_on_tables	rdfs:subClassOf	cn:food
cn:scotch_egg	rdfs:subClassOf	cn:dish
cn:working	cn:causes	cn:produce
cn:meat	cn:usedFor	cn:eating
cn:malaysian_state	rdfs:subClassOf	cn:state
cn:stinkhorn	rdfs:subClassOf	cn:fungus
cn:leaf	cn:usedFor	cn:converting_carbon_dioxide_to_oxygen
cn:shortbread	rdfs:subClassOf	cn:bread
cn:object	cn:hasA	cn:surface
cn:glass	cn:hasProperty	cn:solid
cn:mashed_potato	rdfs:subClassOf	cn:food
cn:orange	rdfs:subClassOf	cn:food
cn:yellow	rdfs:subClassOf	cn:primary_color
cn:snow_cone	rdfs:subClassOf	cn:food
cn:horsemeat	rdfs:subClassOf	cn:meat
cn:chocolate	rdfs:subClassOf	cn:brown
cn:sushi	rdfs:subClassOf	cn:dish
cn:onion	rdfs:subClassOf	cn:vegetable
cn:entertaining_people	cn:hasPrerequisite	cn:food
cn:onion_bread	rdfs:subClassOf	cn:bread
cn:yellow_light	rdfs:subClassOf	cn:yellow
cn:food	cn:receivesAction	cn:found_in_restaurants
cn:orange_juice	rdfs:subClassOf	cn:liquid
cn:damper	rdfs:subClassOf	cn:food
cn:garlic_bread	rdfs:subClassOf	cn:bread
cn:leaves	cn:hasProperty	cn:purple
cn:standing_rib_roast	rdfs:subClassOf	cn:food
cn:ice_cream_cake	rdfs:subClassOf	cn:frozen_dessert
cn:sukiyaki	rdfs:subClassOf	cn:dish
cn:ham_and_eggs	rdfs:subClassOf	cn:dish
cn:matter	cn:hasA	cn:no_electrical_charge
cn:usnea	rdfs:subClassOf	cn:fungus
cn:banana_peels	cn:hasProperty	cn:yellow
cn:mushroom	rdfs:subClassOf	cn:basidiomycete
cn:filet_mignon	rdfs:subClassOf	cn:food
cn:matter	cn:hasProperty	cn:liquid
cn:egg_yolk	rdfs:subClassOf	cn:ingredient
cn:vegetables	cn:hasProperty	cn:good_for_health
cn:deleware	rdfs:subClassOf	cn:state
cn:tortilla_chip	rdfs:subClassOf	cn:food
cn:nut	rdfs:subClassOf	cn:fruit
cn:cake	rdfs:subClassOf	cn:food
cn:target	rdfs:subClassOf	cn:object
cn:mould	rdfs:subClassOf	cn:dish
cn:chokecherry	rdfs:subClassOf	cn:fruit
cn:chocolate	cn:hasProperty	cn:good
cn:balsamic_vinegar	rdfs:subClassOf	cn:food
cn:felt_fungus	rdfs:subClassOf	cn:fungus
cn:pumpkin	rdfs:subClassOf	cn:fruit
cn:walnut	rdfs:subClassOf	cn:fruit
cn:coffee_fungus	rdfs:subClassOf	cn:fungus
cn:fruit	cn:usedFor	cn:decoration
cn:food	cn:usedFor	cn:enhance_sex
cn:sorbet	rdfs:subClassOf	cn:dessert
cn:gyro	rdfs:subClassOf	cn:food
cn:tortilla	rdfs:subClassOf	cn:pancake
cn:crookedness	rdfs:subClassOf	cn:shape
cn:flute	cn:hasProperty	cn:solid
cn:dishonorable	cn:similarTo	cn:yellow
cn:candida_tropicalis	rdfs:subClassOf	cn:fungus
cn:bread	cn:receivesAction	cn:toasted_in_toaster
cn:ice	rdfs:subClassOf	cn:solid
cn:food	cn:receivesAction	cn:stored_in_kitchen
cn:pleurotus	rdfs:subClassOf	cn:fungus
cn:u.s_state	rdfs:subClassOf	cn:state
cn:peas	rdfs:subClassOf	cn:vegetables
cn:monkey_bread	rdfs:subClassOf	cn:food
cn:nonsolid_color	rdfs:subClassOf	cn:color
cn:pholiota_aurea	rdfs:subClassOf	cn:agaric
cn:louisiana	rdfs:subClassOf	cn:state
cn:cucumber	rdfs:subClassOf	cn:plant
cn:cheese_rind	cn:partOf	cn:cheese
cn:fresh_food	rdfs:subClassOf	cn:food
cn:french_toast	rdfs:subClassOf	cn:food
cn:cranberry	rdfs:subClassOf	cn:fruit
cn:ill	cn:similarTo	cn:green
cn:entities	cn:hasA	cn:shape
cn:eurotiales	rdfs:subClassOf	cn:fungus
cn:swiss_cheese	rdfs:subClassOf	cn:cheese
cn:patty	rdfs:subClassOf	cn:dish
cn:ice_cream	rdfs:subClassOf	cn:dessert
cn:cherry	rdfs:subClassOf	cn:fruit
cn:sundae	cn:instanceOf	cn:ice_cream
cn:cotton_candy	rdfs:subClassOf	cn:food
cn:oval	rdfs:subClassOf	cn:round_thing
cn:process_cheese	rdfs:subClassOf	cn:cheese
cn:macowanites_americanus	rdfs:subClassOf	cn:fungus
cn:english_muffin	rdfs:subClassOf	cn:food
cn:vegetables	cn:receivesAction	cn:marinated
cn:lentil_soup	rdfs:subClassOf	cn:soup
cn:bangladesh	rdfs:subClassOf	cn:state
cn:species	rdfs:subClassOf	cn:living_thing
cn:scale	rdfs:subClassOf	cn:leaf
cn:minibar	cn:hasA	cn:food
cn:turkish_delight	rdfs:subClassOf	cn:food
cn:kale	rdfs:subClassOf	cn:cabbage
cn:gymnopilus_validipes	rdfs:subClassOf	cn:agaric
cn:fruit	cn:usedFor	cn:painting_in_still_life
cn:frozen_water	cn:hasProperty	cn:solid
cn:sick_thing	rdfs:subClassOf	cn:living_thing
cn:cyphellostereum	rdfs:subClassOf	cn:fungus
cn:grass_leaf	rdfs:subClassOf	cn:leaf
cn:chocolate	cn:receivesAction	cn:made_from_cocoa_beans
cn:aubergine	rdfs:subClassOf	cn:color
cn:azure	rdfs:subClassOf	cn:color
cn:simnel	rdfs:subClassOf	cn:bread
cn:bovine_meat	rdfs:subClassOf	cn:meat
cn:fruit	cn:hasProperty	cn:sour
cn:soupd	rdfs:subClassOf	cn:food
cn:maple_syrup	rdfs:subClassOf	cn:food
cn:united_states	rdfs:subClassOf	cn:state
cn:spirit	rdfs:subClassOf	cn:liquid
cn:meat	cn:receivesAction	cn:stored_in_freezer
cn:stile	cn:partOf	cn:leaf
cn:blasiphalia	rdfs:subClassOf	cn:fungus
cn:septoria	rdfs:subClassOf	cn:fungus
cn:helium_balloon	cn:usedFor	cn:decoration
cn:marmite	rdfs:subClassOf	cn:soup
cn:prairie_gourd	rdfs:subClassOf	cn:fruit
cn:cabbage	rdfs:subClassOf	cn:cultivated_variety
cn:fruit_salad	cn:instanceOf	cn:dessert
cn:peaches	rdfs:subClassOf	cn:fruit
cn:gland_swollen	rdfs:subClassOf	cn:living_thing
cn:painting	cn:causes	cn:color
cn:miso_soup	rdfs:subClassOf	cn:food
cn:dehydrated_food	rdfs:subClassOf	cn:foodstuff
cn:steak_and_kidney_pie	rdfs:subClassOf	cn:meat_pie
cn:commonwealth_country	rdfs:subClassOf	cn:state
cn:schizocarp	rdfs:subClassOf	cn:fruit
cn:sweetheart_cake	rdfs:subClassOf	cn:food
cn:alligator_pear	rdfs:subClassOf	cn:fruit
cn:milkshake	rdfs:subClassOf	cn:food
cn:melted_solid	rdfs:subClassOf	cn:liquid
cn:county	cn:partOf	cn:state
cn:ambrosia	rdfs:subClassOf	cn:dessert
cn:arizona	rdfs:subClassOf	cn:state
cn:fruit	cn:receivesAction	cn:eaten
cn:mississippi	rdfs:subClassOf	cn:state
cn:slime_mold	rdfs:subClassOf	cn:fungus
cn:fruit	cn:usedFor	cn:cooking
cn:sauce	rdfs:subClassOf	cn:substance
cn:meat	cn:receivesAction	cn:cooked_to_kill_bacteria_in
cn:soup_stock	rdfs:subClassOf	cn:soup
cn:chinese_restaurant	cn:usedFor	cn:food
cn:food	cn:receivesAction	cn:stored_in_fridge
cn:egg	rdfs:subClassOf	cn:foodstuff
cn:meat	cn:usedFor	cn:buying
cn:food	cn:receivesAction	cn:passed_over_fast_food_counter
cn:brussels_sprout	rdfs:subClassOf	cn:cruciferous_vegetable
cn:dish	cn:createdBy	cn:chef
cn:ba_wan	rdfs:subClassOf	cn:food
cn:mozambique	rdfs:subClassOf	cn:state
cn:fruit	cn:usedFor	cn:make_jelly
cn:bread	cn:receivesAction	cn:purchased_with_credit_card
cn:soup_du_jour	rdfs:subClassOf	cn:soup
cn:belarusian_state	rdfs:subClassOf	cn:state
cn:plural_of_vegetable	rdfs:subClassOf	cn:vegetables
cn:rhizoctinia	rdfs:subClassOf	cn:fungus
cn:lettuce	rdfs:subClassOf	cn:vegetable
cn:cupcake	rdfs:subClassOf	cn:food
cn:shepherd's_pie	rdfs:subClassOf	cn:meat_pie
cn:frozen_dessert	rdfs:subClassOf	cn:food
cn:grape	cn:hasProperty	cn:green
cn:oxtail_soup	rdfs:subClassOf	cn:soup
cn:oomycota_division	rdfs:subClassOf	cn:fungus
cn:colour	cn:hasProperty	cn:color
cn:borani	rdfs:subClassOf	cn:food
cn:dry_rot	rdfs:subClassOf	cn:fungus
cn:pepper_steak	rdfs:subClassOf	cn:dish
cn:ice_cream	cn:hasProperty	cn:cold_and_sweet
cn:cheese_pizza	cn:madeOf	cn:tomato_sauce_kneaded_dough_and_cheese
cn:food	cn:capableOf	cn:feed_animals
cn:cheese	rdfs:subClassOf	cn:magazine
cn:milk	rdfs:subClassOf	cn:nutriment
cn:asparagus_stalk	rdfs:subClassOf	cn:vegetable
cn:food	rdfs:subClassOf	cn:not_sex
cn:bigos	rdfs:subClassOf	cn:food
cn:result_of_cooking	rdfs:subClassOf	cn:food
cn:éclair	rdfs:subClassOf	cn:food
cn:boletus_edulis	rdfs:subClassOf	cn:fungus
cn:rose_wine	cn:hasProperty	cn:pink
cn:poisonous_parasol	rdfs:subClassOf	cn:lepiota
cn:green	rdfs:subClassOf	cn:colored_thing
cn:parasol_mushroom	rdfs:subClassOf	cn:agaric
cn:soup	cn:receivesAction	cn:prepared_in_kitchen
cn:spanish_rice	rdfs:subClassOf	cn:dish
cn:macaroni_and_cheese	rdfs:subClassOf	cn:food
cn:matter	cn:receivesAction	cn:converted_to_energy
cn:petite_marmite	rdfs:subClassOf	cn:soup
cn:melba_toast	rdfs:subClassOf	cn:food
cn:most_plant_foliage	cn:hasProperty	cn:green
cn:food	cn:capableOf	cn:grow_moldy
cn:garlic	rdfs:subClassOf	cn:ingredient
cn:white_bread	rdfs:subClassOf	cn:bread
cn:eggs	rdfs:subClassOf	cn:food
cn:liquid	rdfs:subClassOf	cn:not_gas
cn:potato_fungus	rdfs:subClassOf	cn:fungus
cn:cauliflower	cn:hasProperty	cn:white
cn:baseball_cap	rdfs:subClassOf	cn:cap
cn:tomatoes	rdfs:subClassOf	cn:vegetables
cn:one_type_of_bread	rdfs:subClassOf	cn:tortilla
cn:buffet	cn:usedFor	cn:dessert
cn:hazelnut	rdfs:subClassOf	cn:fruit
cn:corn	rdfs:subClassOf	cn:vegetable
cn:almost_all_metals	cn:hasProperty	cn:solid
cn:tortilla	cn:partOf	cn:wrap
cn:leaf	cn:usedFor	cn:play_adam_or_eve
cn:toast_hawaii	rdfs:subClassOf	cn:food
cn:scampi	rdfs:subClassOf	cn:dish
cn:city_state	rdfs:subClassOf	cn:state
cn:leaf	cn:usedFor	cn:cover_up
cn:johnnycake	rdfs:subClassOf	cn:food
cn:cortinarius_subfoetidus	rdfs:subClassOf	cn:agaric
cn:complexion	rdfs:subClassOf	cn:color
cn:new_york	rdfs:subClassOf	cn:state
cn:food	cn:receivesAction	cn:bought_with_currency
cn:fruit	cn:receivesAction	cn:made_into_jellies
cn:barbecued_spareribs	rdfs:subClassOf	cn:dish
cn:meat	rdfs:subClassOf	cn:dead_flesh_of_animal
cn:food	cn:receivesAction	cn:bought_at_market
cn:man_made_object	cn:capableOf	cn:color
cn:lettuce	rdfs:subClassOf	cn:salad
cn:kale	rdfs:subClassOf	cn:vegetable
cn:pholiota_flavida	rdfs:subClassOf	cn:agaric
cn:tabbouleh	rdfs:subClassOf	cn:food
cn:leaf	rdfs:subClassOf	cn:external_anatomical_part
cn:bagel	rdfs:subClassOf	cn:roll
cn:yam	rdfs:subClassOf	cn:vegetable
cn:bleu	rdfs:subClassOf	cn:cheese
cn:china_pink	rdfs:subClassOf	cn:pink
cn:sliced_bread	rdfs:subClassOf	cn:food
cn:biscuit	rdfs:subClassOf	cn:bread
cn:ball	cn:capableOf	cn:roll
cn:potato	rdfs:subClassOf	cn:vegetable
cn:pepernoot	cn:instanceOf	cn:dessert
cn:fregula	rdfs:subClassOf	cn:food
cn:roma_tomato	rdfs:subClassOf	cn:fruit
cn:another_way_to_say_fruit	rdfs:subClassOf	cn:fruit
cn:fruit	cn:usedFor	cn:garnish
cn:fisherman's_soup	rdfs:subClassOf	cn:food
cn:kosher	rdfs:subClassOf	cn:nutriment
cn:dango	rdfs:subClassOf	cn:food
cn:chorizo	rdfs:subClassOf	cn:sausage
cn:honey	rdfs:subClassOf	cn:food
cn:coprinus_comatus	rdfs:subClassOf	cn:fungus
cn:cheeseburger	cn:instanceOf	cn:main_course
cn:suguaros	cn:hasProperty	cn:green
cn:aspergillus	rdfs:subClassOf	cn:fungus
cn:slush	rdfs:subClassOf	cn:food
cn:venison	rdfs:subClassOf	cn:meat
cn:marasmius_oreades	rdfs:subClassOf	cn:fungus
cn:beef_bourguignonne	rdfs:subClassOf	cn:dish
cn:purple	rdfs:subClassOf	cn:violet
cn:watermelon	rdfs:subClassOf	cn:fruit
cn:croquembouche	cn:instanceOf	cn:dessert
cn:sundae	cn:madeOf	cn:ice_cream
cn:coccidioides_immitis	rdfs:subClassOf	cn:fungus
cn:pease_pudding	rdfs:subClassOf	cn:food
cn:soap_dish	rdfs:subClassOf	cn:dish
cn:brown_bread	cn:instanceOf	cn:bread
cn:liquid	cn:similarTo	cn:musical
cn:frozen_yogurt	rdfs:subClassOf	cn:frozen_dessert
cn:peppers_and_peas	rdfs:subClassOf	cn:vegetables
cn:food	cn:receivesAction	cn:bought_at_grocery_store
cn:doner_kebab	rdfs:subClassOf	cn:food
cn:food	rdfs:subClassOf	cn:human_fuel
cn:lot_of_plants	cn:hasProperty	cn:green
cn:eating_in_restaurant	cn:hasPrerequisite	cn:food
cn:bread_crumb	rdfs:subClassOf	cn:bread
cn:wheat_bread	rdfs:subClassOf	cn:bread
cn:japchae	rdfs:subClassOf	cn:food
cn:italian_ice	rdfs:subClassOf	cn:food
cn:cheese	cn:receivesAction	cn:bought_at_grocery
cn:ice_cream	rdfs:subClassOf	cn:solid_food
cn:rissole	rdfs:subClassOf	cn:dish
cn:gold	cn:usedFor	cn:decoration
cn:coral_fungus	rdfs:subClassOf	cn:fungus
cn:hot_pot	rdfs:subClassOf	cn:food
cn:wheat_leaf_rust	rdfs:subClassOf	cn:fungus
cn:kishke	rdfs:subClassOf	cn:dish
cn:eat_dinner	cn:motivatedByGoal	cn:food
cn:fungus	cn:capableOf	cn:grows_on_dead_trees
cn:goose_meat	rdfs:subClassOf	cn:meat
cn:asymptomatic_thing	rdfs:subClassOf	cn:living_thing
cn:kaymak	cn:instanceOf	cn:dessert
cn:pizza	cn:createdBy	cn:pizza_store
cn:cabécou	rdfs:subClassOf	cn:cheese
cn:bucatini	rdfs:subClassOf	cn:food
cn:coconut	rdfs:subClassOf	cn:living_thing
cn:champignon_cheese	rdfs:subClassOf	cn:cheese
cn:cucumber	rdfs:subClassOf	cn:melon
cn:heel	cn:partOf	cn:loaf_of_bread
cn:tablecloth	cn:usedFor	cn:decoration
cn:cheese	cn:capableOf	cn:have_pungent_smell
cn:andouille	cn:instanceOf	cn:sausage
cn:rhizopogon	rdfs:subClassOf	cn:fungus
cn:rum_baba	rdfs:subClassOf	cn:food
cn:cheeseburger	rdfs:subClassOf	cn:food
cn:magiritsa	rdfs:subClassOf	cn:food
cn:quiche	rdfs:subClassOf	cn:food
cn:prinzregententorte	rdfs:subClassOf	cn:food
cn:gochujang	rdfs:subClassOf	cn:food
cn:rice_pudding	rdfs:subClassOf	cn:food
cn:lutefisk	rdfs:subClassOf	cn:dish
cn:produce	rdfs:subClassOf	cn:output
cn:pichia_pastoris	rdfs:subClassOf	cn:fungus
cn:candy	rdfs:subClassOf	cn:food
cn:dominion	rdfs:subClassOf	cn:state
cn:mung_beans	rdfs:subClassOf	cn:vegetables
cn:tomatoes	rdfs:subClassOf	cn:vegetable
cn:plastic	cn:hasProperty	cn:solid
cn:violet	rdfs:subClassOf	cn:color
cn:pumpkin_pie	rdfs:subClassOf	cn:dessert
cn:spring_roll	rdfs:subClassOf	cn:food
cn:chocolate	cn:capableOf	cn:coat_cherries
cn:fruit	rdfs:subClassOf	cn:living_thing
cn:stoemp	rdfs:subClassOf	cn:food
cn:meat	rdfs:subClassOf	cn:form_of_protein
cn:cortinarius_semisanguineus	rdfs:subClassOf	cn:agaric
cn:unaged	cn:similarTo	cn:green
cn:hamburger	cn:similarTo	cn:chicken_burger
cn:coca_plant_leaf	rdfs:subClassOf	cn:leaf
cn:dish	cn:usedFor	cn:food
cn:nidulariaceae	rdfs:subClassOf	cn:fungus
cn:sausage_pizza	rdfs:subClassOf	cn:pizza
cn:cobbler	rdfs:subClassOf	cn:food
cn:oklahoma	rdfs:subClassOf	cn:state
cn:gastroboletus_turbinatus	rdfs:subClassOf	cn:fungus
cn:blastocladiomycota	rdfs:subClassOf	cn:fungus
cn:animal	cn:usedFor	cn:food
cn:meat	cn:usedFor	cn:butchers_to_sell
cn:biryani	rdfs:subClassOf	cn:food
cn:trenette	rdfs:subClassOf	cn:food
cn:dark_bread	rdfs:subClassOf	cn:bread
cn:pizza	rdfs:subClassOf	cn:hot_food_or_drink
cn:sisig	rdfs:subClassOf	cn:food
cn:apple_butter	rdfs:subClassOf	cn:food
cn:migas	rdfs:subClassOf	cn:food
cn:focaccia	rdfs:subClassOf	cn:food
cn:pomegranate	rdfs:subClassOf	cn:fruit
cn:marble_cake	rdfs:subClassOf	cn:food
cn:artichokes	cn:hasProperty	cn:green
cn:matzo	rdfs:subClassOf	cn:bread
cn:metals	cn:hasProperty	cn:solid
cn:dashi	rdfs:subClassOf	cn:food
cn:slice	cn:partOf	cn:golf_game
cn:purple	rdfs:subClassOf	cn:mix_of_red_and_blue
cn:coconut	rdfs:subClassOf	cn:food
cn:dish	cn:usedFor	cn:eating_food
cn:all_beverages	cn:hasProperty	cn:liquid
cn:tamale	rdfs:subClassOf	cn:dish
cn:orchids	cn:hasProperty	cn:purple
cn:baked_alaska	rdfs:subClassOf	cn:food
cn:bread	cn:hasProperty	cn:high_in_carbohydrates
cn:edamame	rdfs:subClassOf	cn:course
cn:food	cn:causesDesire	cn:eat
cn:charlotte	rdfs:subClassOf	cn:food
cn:juice	rdfs:subClassOf	cn:foodstuff
cn:fajita	rdfs:subClassOf	cn:food
cn:brioche	rdfs:subClassOf	cn:food
cn:cyan	rdfs:subClassOf	cn:color
cn:tostada	rdfs:subClassOf	cn:dish
cn:square	rdfs:subClassOf	cn:shape
cn:vegetables	cn:receivesAction	cn:eaten_without_cooking
cn:fruit	cn:hasA	cn:pleasant_taste
cn:liskov_substitution_principle	rdfs:subClassOf	cn:solid
cn:pudding	rdfs:subClassOf	cn:food
cn:roast_beef	rdfs:subClassOf	cn:food
cn:meat	cn:usedFor	cn:getting_protein_in_diet
cn:manna	rdfs:subClassOf	cn:food
cn:ripe_fruit	rdfs:subClassOf	cn:fruit
cn:rose	rdfs:subClassOf	cn:pink
cn:eating_healthily	cn:hasPrerequisite	cn:fruit
cn:chocolate_ice_cream	rdfs:subClassOf	cn:ice_cream
cn:food	cn:capableOf	cn:please_hungry
cn:commonwealth	rdfs:subClassOf	cn:state
cn:akutaq	rdfs:subClassOf	cn:food
cn:bread	cn:usedFor	cn:sandwiches
cn:cake	rdfs:subClassOf	cn:dessert
cn:food	cn:receivesAction	cn:eaten
cn:trail_mix	cn:instanceOf	cn:snack_food
cn:rum_ball	cn:instanceOf	cn:dessert
cn:lettuce	cn:dbpedia/genus	cn:lactuca
cn:ice_cream	rdfs:subClassOf	cn:tasty_treat
cn:octopus_consists_of_physically	rdfs:subClassOf	cn:meat
cn:red_peppers	rdfs:subClassOf	cn:vegetables
cn:dish	cn:usedFor	cn:serve_food_on
cn:fungus	rdfs:subClassOf	cn:heterotroph
cn:common_marker_color	cn:hasProperty	cn:yellow
cn:lesotho	rdfs:subClassOf	cn:state
cn:cheeseburger	rdfs:subClassOf	cn:hamburger
cn:pink	rdfs:subClassOf	cn:colour
cn:trapezoid	rdfs:subClassOf	cn:shape
cn:betel_leaf	rdfs:subClassOf	cn:leaf
cn:hamburger	cn:receivesAction	cn:bought_at_fastfood_joint
cn:bread	rdfs:subClassOf	cn:staple_for_meal
cn:physcia_stellaris	rdfs:subClassOf	cn:fungus
cn:destroying_angel	rdfs:subClassOf	cn:agaric
cn:lepiota_clypeolaria	rdfs:subClassOf	cn:lepiota
cn:galette	rdfs:subClassOf	cn:food
cn:deviled_egg	rdfs:subClassOf	cn:dish
cn:chorizo	cn:instanceOf	cn:sausage
cn:afghanistan	rdfs:subClassOf	cn:state
cn:chilli_crab	rdfs:subClassOf	cn:food
cn:jau_gok	rdfs:subClassOf	cn:food
cn:compote	rdfs:subClassOf	cn:food
cn:toast	rdfs:subClassOf	cn:bread
cn:orange	cn:partOf	cn:fruit
cn:taste_sweet	cn:motivatedByGoal	cn:chocolate
cn:soup	rdfs:subClassOf	cn:good_food
cn:food	cn:receivesAction	cn:purchased_at_mall
cn:bread	cn:partOf	cn:sandwich
cn:agaric	rdfs:subClassOf	cn:fungus
cn:volvariella_bombycina	rdfs:subClassOf	cn:agaric
cn:glue	rdfs:subClassOf	cn:substance
cn:hygrocybe	rdfs:subClassOf	cn:fungus
cn:cooking_meal	cn:usedFor	cn:food
cn:leaf	rdfs:subClassOf	cn:plant_organ
cn:love_seat	cn:usedFor	cn:decoration
cn:piano	cn:hasProperty	cn:solid
cn:spizellomycetales	rdfs:subClassOf	cn:fungus
cn:chlorophyll	rdfs:subClassOf	cn:green
cn:pasta	rdfs:subClassOf	cn:dish
cn:sordariomycetes	rdfs:subClassOf	cn:fungus
cn:dessert	rdfs:subClassOf	cn:course
cn:dentate_leaf	rdfs:subClassOf	cn:leaf
cn:burmese_state	rdfs:subClassOf	cn:state
cn:bread	cn:usedFor	cn:satiating_hunger
cn:pillow_case	cn:usedFor	cn:decoration
cn:chocolate	cn:usedFor	cn:eating
cn:column	cn:usedFor	cn:decoration
cn:terrorist_who_male	rdfs:subClassOf	cn:living_thing
cn:french_loaf	rdfs:subClassOf	cn:loaf_of_bread
cn:alphabet_soup	rdfs:subClassOf	cn:food
cn:fruit	rdfs:subClassOf	cn:another_name_for_homosexual
cn:apples	cn:hasProperty	cn:yellow
cn:brown_bread	rdfs:subClassOf	cn:bread
cn:turkish_delight	cn:instanceOf	cn:dessert
cn:hamburger	rdfs:subClassOf	cn:hot_food_or_drink
cn:poffertjes	rdfs:subClassOf	cn:food
cn:burger	rdfs:subClassOf	cn:food
cn:bluish_green	rdfs:subClassOf	cn:green
cn:lepiota_rubrotincta	rdfs:subClassOf	cn:lepiota
cn:tires	cn:hasProperty	cn:circular
cn:uttapam	rdfs:subClassOf	cn:food
cn:queensland	rdfs:subClassOf	cn:state
cn:hearts_of_romaine_lettuce	rdfs:subClassOf	cn:lettuce
cn:cetraria	rdfs:subClassOf	cn:fungus
cn:restaurant_and_theatre	cn:hasA	cn:food
cn:blackberry	rdfs:subClassOf	cn:fruit
cn:achromatic_color	rdfs:subClassOf	cn:color
cn:brown_root_rot_fungus	rdfs:subClassOf	cn:fungus
cn:varieties_of_apples	cn:hasProperty	cn:green
cn:state	cn:definedAs	cn:singular_form_of_plural_states
cn:straw_mushroom	rdfs:subClassOf	cn:agaric
cn:golden_delicious_apple	rdfs:subClassOf	cn:fruit
cn:comfit	rdfs:subClassOf	cn:food
cn:clothes	cn:hasProperty	cn:purple
cn:vegetables	cn:receivesAction	cn:grown_in_garden
cn:scrapple	rdfs:subClassOf	cn:dish
cn:connecticut	rdfs:subClassOf	cn:state
cn:breadstick	cn:instanceOf	cn:bread
cn:cabbage	rdfs:subClassOf	cn:vegetable
cn:hamburger	cn:hasProperty	cn:well_over_300_caleries
cn:ingesta	rdfs:subClassOf	cn:nutriment
cn:eggs_benedict	rdfs:subClassOf	cn:food
cn:okonomiyaki	rdfs:subClassOf	cn:food
cn:rye_bread	rdfs:subClassOf	cn:bread
cn:canton_swiss	rdfs:subClassOf	cn:state
cn:state	cn:capableOf	cn:levy_taxes
cn:ice_cream	rdfs:subClassOf	cn:mixture
cn:alaska	rdfs:subClassOf	cn:state
cn:pennsylvania	rdfs:subClassOf	cn:state
cn:liquid	cn:capableOf	cn:become_solid_by_cooling
cn:flower_of_hypericum_perforatum	rdfs:subClassOf	cn:yellow
cn:food	cn:receivesAction	cn:cooked_in_kitchen
cn:deviled_egg	rdfs:subClassOf	cn:food
cn:lasagne	rdfs:subClassOf	cn:food
cn:fondue	rdfs:subClassOf	cn:food
cn:cauliflower	rdfs:subClassOf	cn:cruciferous_vegetable
cn:gloeophyllaceae	rdfs:subClassOf	cn:fungus
cn:noodle	rdfs:subClassOf	cn:food
cn:pen	rdfs:subClassOf	cn:object
cn:clitocybe_clavipes	rdfs:subClassOf	cn:agaric
cn:dish	rdfs:subClassOf	cn:non_powered_device
cn:rodent	rdfs:subClassOf	cn:meat
cn:sushi	rdfs:subClassOf	cn:course
cn:fresh_vegetables	cn:hasProperty	cn:green
cn:sausage	cn:similarTo	cn:kishke
cn:washington	rdfs:subClassOf	cn:state
cn:bread_pudding	rdfs:subClassOf	cn:food
cn:meze	rdfs:subClassOf	cn:food
cn:jack_o_lantern_fungus	rdfs:subClassOf	cn:agaric
cn:color	cn:hasProperty	cn:dark
cn:sentience	rdfs:subClassOf	cn:state
cn:animal	rdfs:subClassOf	cn:organism
cn:chow_mein	rdfs:subClassOf	cn:dish
cn:fruit	rdfs:subClassOf	cn:excellent_source_of_dietary_fibre
cn:cheese	rdfs:subClassOf	cn:pizza_topping
cn:venturia	rdfs:subClassOf	cn:fungus
cn:eating_ice_cream	cn:usedFor	cn:food
cn:eukaryoyte	rdfs:subClassOf	cn:organism
cn:loreleia	rdfs:subClassOf	cn:fungus
cn:hotdog	rdfs:subClassOf	cn:sandwich
cn:green_light	rdfs:subClassOf	cn:green
cn:dartboard	rdfs:subClassOf	cn:object
cn:fruit	cn:hasProperty	cn:good_for_health
cn:nori	rdfs:subClassOf	cn:green
cn:brewed_coffee	rdfs:subClassOf	cn:liquid
cn:pizza	cn:causesDesire	cn:drink
cn:indian_state	rdfs:subClassOf	cn:state
cn:kaymak	rdfs:subClassOf	cn:food
cn:béarnaise_sauce	rdfs:subClassOf	cn:food
cn:pudding	rdfs:subClassOf	cn:dessert
cn:bird	rdfs:subClassOf	cn:meat
cn:charlotte	cn:instanceOf	cn:dessert
cn:vegetables	cn:receivesAction	cn:served_in_dishes
cn:toast	rdfs:subClassOf	cn:food
cn:make_shopping_list	cn:motivatedByGoal	cn:food
cn:leblebi	cn:instanceOf	cn:snack_food
cn:guyana	rdfs:subClassOf	cn:state
cn:saccharomyces_cerevisiae	rdfs:subClassOf	cn:fungus
cn:paella	rdfs:subClassOf	cn:dish
cn:flour	rdfs:subClassOf	cn:foodstuff
cn:fruit	cn:capableOf	cn:become_ripe
cn:organism_part	rdfs:subClassOf	cn:living_thing
cn:beach_strawberry	rdfs:subClassOf	cn:strawberry
cn:psilocybe	rdfs:subClassOf	cn:fungus
cn:tortilla	cn:instanceOf	cn:flatbread
cn:leaf	cn:capableOf	cn:float_down_stream
cn:junk_food	rdfs:subClassOf	cn:food
cn:nigeria	rdfs:subClassOf	cn:state
cn:food	cn:receivesAction	cn:made_from_animals_or_plants
cn:greens	rdfs:subClassOf	cn:vegetable
cn:unripe_oranges	cn:hasProperty	cn:green
cn:baked_alaska	rdfs:subClassOf	cn:dessert
cn:chocolate	cn:capableOf	cn:melt
cn:steak_sandwich	rdfs:subClassOf	cn:sandwich
cn:rabbit	rdfs:subClassOf	cn:meat
cn:julienne_vegetable	rdfs:subClassOf	cn:vegetable
cn:edible_bird's_nest	rdfs:subClassOf	cn:food
cn:meatball	rdfs:subClassOf	cn:dish
cn:cheese	cn:capableOf	cn:age_to_get_better
cn:lichenomphalia	rdfs:subClassOf	cn:fungus
cn:funeral_potatoes	rdfs:subClassOf	cn:food
cn:food	cn:receivesAction	cn:bought_at_grocery
cn:false_deathcap	rdfs:subClassOf	cn:agaric
cn:yellow	rdfs:subClassOf	cn:yellowish_thing
cn:leaf	cn:usedFor	cn:decomposing_and_making_soil
cn:muffin	rdfs:subClassOf	cn:food
cn:object	cn:capableOf	cn:sound_well
cn:red	rdfs:subClassOf	cn:color
cn:chocolate	rdfs:subClassOf	cn:food_composite
cn:when_unripe_bananas	cn:hasProperty	cn:green
cn:monument	cn:usedFor	cn:decoration
cn:green	rdfs:subClassOf	cn:acolor
cn:pastry	rdfs:subClassOf	cn:baked_goods
cn:cladonia_rangiferina	rdfs:subClassOf	cn:fungus
cn:vegetable	rdfs:subClassOf	cn:grocery
cn:tea_leaf	rdfs:subClassOf	cn:leaf
cn:hamburger	cn:receivesAction	cn:made_from_beef
cn:cabbage	rdfs:subClassOf	cn:crucifer
cn:aspergillus_fumigatus	rdfs:subClassOf	cn:fungus
cn:hereditary_ailment	rdfs:subClassOf	cn:living_thing
cn:butty	rdfs:subClassOf	cn:sandwich
cn:meat	cn:receivesAction	cn:sold_by_butcher
cn:jamaica	rdfs:subClassOf	cn:state
cn:bacon_and_eggs	rdfs:subClassOf	cn:dish
cn:moussaka	rdfs:subClassOf	cn:food
cn:ocean	cn:hasProperty	cn:liquid
cn:marshmallow	rdfs:subClassOf	cn:food
cn:color	rdfs:subClassOf	cn:cause_by_reflection_of_light
cn:lecanora	rdfs:subClassOf	cn:fungus
cn:kalakukko	rdfs:subClassOf	cn:food
cn:pilaf	rdfs:subClassOf	cn:dish
cn:fruit	cn:receivesAction	cn:considered_healthy_food
cn:leaf_tea	rdfs:subClassOf	cn:living_thing
cn:coleslaw	rdfs:subClassOf	cn:food
cn:vegetables	cn:receivesAction	cn:used_in_many_foods_including_soup
cn:meat_loaf	rdfs:subClassOf	cn:dish
cn:linguine	rdfs:subClassOf	cn:food
cn:hawaii	rdfs:subClassOf	cn:state
cn:starving_man	cn:desires	cn:food
cn:flower	cn:hasProperty	cn:yellow
cn:pluteus_magnus	rdfs:subClassOf	cn:agaric
cn:cocoa_powder	rdfs:subClassOf	cn:chocolate
cn:green	rdfs:subClassOf	cn:greenish_thing
cn:sea_power	rdfs:subClassOf	cn:state
cn:united_states_of_america	rdfs:subClassOf	cn:state
cn:coq_au_vin	rdfs:subClassOf	cn:food
cn:color	rdfs:subClassOf	cn:visible_feature
cn:iceland_moss	rdfs:subClassOf	cn:fungus
cn:sandwich_wrap	rdfs:subClassOf	cn:sandwich
cn:raclette_cheese	rdfs:subClassOf	cn:cheese
cn:ice_cream	rdfs:subClassOf	cn:colder_than_human_ambient_temperature
cn:bread	rdfs:subClassOf	cn:spongy_thing
cn:meat	rdfs:subClassOf	cn:meat_or_legume_food
cn:matter	cn:hasA	cn:mass
cn:india	rdfs:subClassOf	cn:state
cn:soy_milk	rdfs:subClassOf	cn:food
cn:ham	rdfs:subClassOf	cn:food
cn:yellow_green	rdfs:subClassOf	cn:green
cn:onion_bulb	rdfs:subClassOf	cn:living_thing
cn:deodorant	rdfs:subClassOf	cn:substance
cn:succotash	rdfs:subClassOf	cn:dish
cn:antidoron	rdfs:subClassOf	cn:food
cn:cd	cn:hasProperty	cn:solid
cn:torte	rdfs:subClassOf	cn:food
cn:parish	rdfs:subClassOf	cn:state
cn:pink_disease_fungus	rdfs:subClassOf	cn:fungus
cn:ear	rdfs:subClassOf	cn:fruit
cn:tartar_sauce	rdfs:subClassOf	cn:food
cn:finger_food	rdfs:subClassOf	cn:nutriment
cn:sandwich	rdfs:subClassOf	cn:meal_commonly
cn:gastroboletus_scabrosus	rdfs:subClassOf	cn:fungus
cn:eat_hamburger	cn:motivatedByGoal	cn:meat
cn:ladyfinger	rdfs:subClassOf	cn:food
cn:vodka	cn:hasProperty	cn:liquid
cn:peas	rdfs:subClassOf	cn:food
cn:buff	rdfs:subClassOf	cn:skin
cn:bread	cn:usedFor	cn:making_bread_and_butter_pudding_with
cn:strawberry	cn:partOf	cn:garden_strawberry
cn:color	rdfs:subClassOf	cn:attribute_of_objects
cn:oyster_mushroom	rdfs:subClassOf	cn:agaric
cn:mushroom	rdfs:subClassOf	cn:vegetable
cn:food	cn:receivesAction	cn:built_of_carbon
cn:cruciferous_vegetable	cn:partOf	cn:crucifer
cn:rum_ball	rdfs:subClassOf	cn:food
cn:pink	rdfs:subClassOf	cn:flower
cn:clitocybe_inornata	rdfs:subClassOf	cn:agaric
cn:swiss_steak	rdfs:subClassOf	cn:dish
cn:peach	cn:dbpedia/genus	cn:prunus
cn:head_lettuce	rdfs:subClassOf	cn:lettuce
cn:broth	rdfs:subClassOf	cn:soup
cn:vegetables	cn:hasProperty	cn:edible
cn:duck_meat	rdfs:subClassOf	cn:meat
cn:moussaka	rdfs:subClassOf	cn:dish
cn:turnip	rdfs:subClassOf	cn:vegetable
cn:pizza	rdfs:subClassOf	cn:food_composite
cn:liquid	rdfs:subClassOf	cn:state_of_matter
cn:cabbage	cn:causes	cn:gas
cn:main_course	rdfs:subClassOf	cn:course
cn:brioche	cn:instanceOf	cn:bread
cn:cos_lettuce	rdfs:subClassOf	cn:lettuce
cn:floccose_chanterelle	rdfs:subClassOf	cn:agaric
cn:false_morel	rdfs:subClassOf	cn:fungus
cn:claviceps_purpurea	rdfs:subClassOf	cn:fungus
cn:bread	cn:receivesAction	cn:cooked
cn:spanish_omelette	rdfs:subClassOf	cn:food
cn:dodecahedron	rdfs:subClassOf	cn:solid
cn:tangyuan	rdfs:subClassOf	cn:food
cn:bread	cn:usedFor	cn:toasting
cn:maple_sugar	rdfs:subClassOf	cn:food
cn:enchilada	rdfs:subClassOf	cn:food
cn:ball	cn:hasProperty	cn:circular
cn:tennessee	rdfs:subClassOf	cn:state
cn:crème_caramel	cn:instanceOf	cn:dessert
cn:snail	rdfs:subClassOf	cn:meat
cn:sub	rdfs:subClassOf	cn:sandwich
cn:tricholoma_sejunctum	rdfs:subClassOf	cn:agaric
cn:chocolate	rdfs:subClassOf	cn:dessert
cn:corn_chip	rdfs:subClassOf	cn:snack_food
cn:vegetable	cn:hasProperty	cn:one_kind_of_plant
cn:fruit	cn:definedAs	cn:ovary_of_angiosperm
cn:pringles	cn:instanceOf	cn:snack_food
cn:lettuce	rdfs:subClassOf	cn:herb
cn:produce	rdfs:subClassOf	cn:food
cn:coronation_chicken	rdfs:subClassOf	cn:food
cn:bread	cn:usedFor	cn:feeding_to_birds
cn:dish	cn:usedFor	cn:letching_at
cn:unsweetened_baking_chocolate	rdfs:subClassOf	cn:chocolate
cn:leonidas	cn:dbpedia/product	cn:chocolate
cn:tile	cn:usedFor	cn:decoration
cn:stropharia_ambigua	rdfs:subClassOf	cn:agaric
cn:castella	rdfs:subClassOf	cn:food
cn:meat	cn:usedFor	cn:marinating
cn:developing_country	rdfs:subClassOf	cn:state
cn:sausage	cn:receivesAction	cn:eaten
cn:lettuce	rdfs:subClassOf	cn:plant
cn:broccoli_foodstuff	rdfs:subClassOf	cn:vegetable
cn:oden	cn:instanceOf	cn:soup
cn:bread	cn:usedFor	cn:nutrition
cn:spotted_dick	rdfs:subClassOf	cn:food
cn:minestrone	rdfs:subClassOf	cn:food
cn:flatbread	rdfs:subClassOf	cn:food
cn:soup	cn:receivesAction	cn:eaten_out_of_bowl
cn:lichen	rdfs:subClassOf	cn:fungus
cn:meat	cn:receivesAction	cn:used_in_many_recipes
cn:basidiomycete	rdfs:subClassOf	cn:fungus
cn:pizza	cn:hasA	cn:cheese_on
cn:gravy_bowl	rdfs:subClassOf	cn:dish
cn:pork_sausage	rdfs:subClassOf	cn:sausage
cn:manti	rdfs:subClassOf	cn:food
cn:cauliflower	cn:hasProperty	cn:eaten_cooked_or_raw
cn:parmesan	rdfs:subClassOf	cn:cheese
cn:vla	rdfs:subClassOf	cn:food
cn:basidiomycota	rdfs:subClassOf	cn:fungus
cn:brussel_sprout	rdfs:subClassOf	cn:vegetable
cn:steak_tartare	rdfs:subClassOf	cn:food
cn:crème_brûlée	rdfs:subClassOf	cn:food
cn:pink	rdfs:subClassOf	cn:terrible_color_for_interior_decor
cn:salad	rdfs:subClassOf	cn:dish
cn:baking_cake	cn:usedFor	cn:dessert
cn:souse	rdfs:subClassOf	cn:sausage
cn:cheese	rdfs:subClassOf	cn:food
cn:angel_food_cake	rdfs:subClassOf	cn:food
cn:cauliflower	cn:partOf	cn:cauliflower
cn:necklace	cn:usedFor	cn:decoration
cn:waterzooi	rdfs:subClassOf	cn:food
cn:peppers	cn:hasProperty	cn:green
cn:vegetables	cn:receivesAction	cn:served_at_most_restaurants
cn:lefse	rdfs:subClassOf	cn:food
cn:armillaria	rdfs:subClassOf	cn:fungus
cn:syllabub	rdfs:subClassOf	cn:dessert
cn:caul_fat	rdfs:subClassOf	cn:food
cn:choux_pastry	rdfs:subClassOf	cn:food
cn:granita	cn:instanceOf	cn:dessert
cn:squash	rdfs:subClassOf	cn:fruit
cn:watch	cn:hasProperty	cn:solid
cn:deuteromycota	rdfs:subClassOf	cn:fungus
cn:gnocchi	rdfs:subClassOf	cn:food
cn:bread	cn:usedFor	cn:making_toast
cn:eggdrop_soup	rdfs:subClassOf	cn:soup
cn:eating_vegetables	cn:hasPrerequisite	cn:vegetables
cn:dolma	rdfs:subClassOf	cn:food
cn:hymenomycete	rdfs:subClassOf	cn:fungus
cn:octagon	rdfs:subClassOf	cn:shape
cn:ice_cream	cn:hasProperty	cn:cold_creamy_and_sweet
cn:black_currant	rdfs:subClassOf	cn:living_thing
cn:adams_pearmain_apple	rdfs:subClassOf	cn:fruit
cn:leaf	cn:partOf	cn:tree
cn:celtuce	rdfs:subClassOf	cn:lettuce
cn:wafer	rdfs:subClassOf	cn:bread
cn:venezuelan_state	rdfs:subClassOf	cn:state
cn:challah	rdfs:subClassOf	cn:food
cn:purple	rdfs:subClassOf	cn:secondary_colour
cn:lettuce_sandwich	rdfs:subClassOf	cn:sandwich
cn:food	cn:receivesAction	cn:stored_in_tupperware
cn:ravioli	rdfs:subClassOf	cn:food
cn:frozen_carbon_dioxide	cn:hasProperty	cn:solid
cn:banchan	rdfs:subClassOf	cn:food
cn:sweet_william	rdfs:subClassOf	cn:pink
cn:food	cn:hasA	cn:effect_of_suppressing_hunger
cn:caesar_salad	rdfs:subClassOf	cn:food
cn:croque_monsieur	cn:instanceOf	cn:sandwich
cn:dominica	rdfs:subClassOf	cn:state
cn:croquembouche	rdfs:subClassOf	cn:food
cn:pistachio	rdfs:subClassOf	cn:living_thing
cn:fruit	cn:usedFor	cn:making_juice
cn:thuringian_sausage	cn:instanceOf	cn:sausage
cn:oval	cn:receivesAction	cn:curved
cn:pichia	rdfs:subClassOf	cn:fungus
cn:pizza	rdfs:subClassOf	cn:finger_food
cn:meat	cn:receivesAction	cn:served_at_restaurants
cn:sarcosomataceae	rdfs:subClassOf	cn:fungus
cn:leek	rdfs:subClassOf	cn:vegetable
cn:lettuce	cn:usedFor	cn:make_salad
cn:chocolate_brownie	rdfs:subClassOf	cn:food
cn:pepper	rdfs:subClassOf	cn:vegetable
cn:bakewell_tart	rdfs:subClassOf	cn:food
cn:karl_tries_to_drink	rdfs:subClassOf	cn:soup
cn:candida_krusei	rdfs:subClassOf	cn:fungus
cn:dish	cn:usedFor	cn:displaying_food
cn:historic_british_county	rdfs:subClassOf	cn:state
cn:bread	rdfs:subClassOf	cn:starches
cn:orchids	cn:hasProperty	cn:yellow
cn:mortarboard	rdfs:subClassOf	cn:cap
cn:basidiocarp	cn:partOf	cn:basidiomycete
cn:hamburger	rdfs:subClassOf	cn:sandwich
cn:sopaipilla	rdfs:subClassOf	cn:food
cn:roll	rdfs:subClassOf	cn:piece_of_baked_dough
cn:red_currant	rdfs:subClassOf	cn:living_thing
cn:fruit	rdfs:subClassOf	cn:better_snack_than_candy
cn:triple_cream	rdfs:subClassOf	cn:cheese
cn:liquid	cn:similarTo	cn:liquified
cn:schnitzel	rdfs:subClassOf	cn:dish
cn:administrative_county_of_england	rdfs:subClassOf	cn:state
cn:whip	rdfs:subClassOf	cn:dessert
cn:embryo	rdfs:subClassOf	cn:living_thing
cn:ray_flesh	rdfs:subClassOf	cn:meat
cn:bronze_yellow	rdfs:subClassOf	cn:yellow
cn:bottle	cn:hasA	cn:liquid
cn:interface_segregation_principle	rdfs:subClassOf	cn:solid
cn:muenster	rdfs:subClassOf	cn:cheese
cn:liquid	cn:similarTo	cn:watery
cn:yellow_road_sign	rdfs:subClassOf	cn:yellow
cn:parakeets	cn:hasProperty	cn:green
cn:omphalina	rdfs:subClassOf	cn:fungus
cn:lobster_roll	rdfs:subClassOf	cn:sandwich
cn:hard_sauce	rdfs:subClassOf	cn:food
cn:pizzeria_sells_pizza_which	rdfs:subClassOf	cn:food
cn:rectangular	rdfs:subClassOf	cn:shape
cn:croissant	rdfs:subClassOf	cn:food
cn:nonpareils	rdfs:subClassOf	cn:food
cn:apple	cn:hasProperty	cn:green
cn:ice_cream	rdfs:subClassOf	cn:tasty_food
cn:lassi	rdfs:subClassOf	cn:food
cn:taiyaki	rdfs:subClassOf	cn:food
cn:dacquoise	rdfs:subClassOf	cn:food
cn:entoloma_lividum	rdfs:subClassOf	cn:agaric
cn:strawberry	rdfs:subClassOf	cn:fruit
cn:mexican_restaurant	cn:usedFor	cn:food
cn:tamale_pie	rdfs:subClassOf	cn:dish
cn:chicken	cn:capableOf	cn:food
cn:clitocybe_robusta	rdfs:subClassOf	cn:agaric
cn:fried_egg	rdfs:subClassOf	cn:dish
cn:armillaria_ponderosa	rdfs:subClassOf	cn:agaric
cn:cheese	rdfs:subClassOf	cn:mixture
cn:fudge	rdfs:subClassOf	cn:food
cn:dullness	rdfs:subClassOf	cn:shape
cn:beer	cn:hasProperty	cn:liquid
cn:challah	rdfs:subClassOf	cn:bread
cn:cladonia	rdfs:subClassOf	cn:fungus
cn:auriscalpiaceae	rdfs:subClassOf	cn:fungus
cn:pholiota_flammans	rdfs:subClassOf	cn:agaric
cn:ajvar	rdfs:subClassOf	cn:food
cn:bok_choy	rdfs:subClassOf	cn:cabbage
cn:green	cn:similarTo	cn:unaged
cn:taleggio_cheese	rdfs:subClassOf	cn:cheese
cn:disposable	cn:similarTo	cn:liquid
cn:leaf	cn:capableOf	cn:turn_different_colors
cn:color	cn:hasProperty	cn:important_to_who_painting
cn:every_part	rdfs:subClassOf	cn:whole
cn:bread	cn:usedFor	cn:consumption
cn:baklava	rdfs:subClassOf	cn:food
cn:soup	rdfs:subClassOf	cn:liquid
cn:solid	rdfs:subClassOf	cn:state_of_matter
cn:meat	cn:usedFor	cn:eat
cn:chocolate	cn:hasProperty	cn:yummy
cn:basket_with_handle	cn:usedFor	cn:decoration
cn:billibi	rdfs:subClassOf	cn:soup
cn:purple	rdfs:subClassOf	cn:chromatic_color
cn:vegetables	rdfs:subClassOf	cn:tubers
cn:yakitori	rdfs:subClassOf	cn:dish
cn:liquid	cn:similarTo	cn:liquefiable
cn:accessory_fruit	rdfs:subClassOf	cn:fruit
cn:extended	rdfs:subClassOf	cn:living_thing
cn:fruit	cn:capableOf	cn:go_off
cn:meat	cn:usedFor	cn:eating_protein
cn:arepa	rdfs:subClassOf	cn:food
cn:dessert	cn:capableOf	cn:follow_dinner
cn:bean_pod	rdfs:subClassOf	cn:vegetable
cn:maldives	rdfs:subClassOf	cn:state
cn:raptorial_bird_flesh	rdfs:subClassOf	cn:meat
cn:blood_sausage	rdfs:subClassOf	cn:food
cn:meat_sauce	cn:similarTo	cn:tomato_sauce
cn:youtiao	rdfs:subClassOf	cn:food
cn:gyromitra_fastigiata	rdfs:subClassOf	cn:fungus
cn:fruit	cn:usedFor	cn:reproducing_plant_came_from
cn:bread	cn:definedAs	cn:substrate_for_sandwich
cn:pasty	rdfs:subClassOf	cn:meat_pie
cn:onion_and_celery	rdfs:subClassOf	cn:vegetables
cn:double_gloucester	rdfs:subClassOf	cn:cheese
cn:meat	rdfs:subClassOf	cn:animal_flesh
cn:lavash	rdfs:subClassOf	cn:food
cn:agaricaceae	rdfs:subClassOf	cn:fungus
cn:junket	rdfs:subClassOf	cn:dessert
cn:tuna	rdfs:subClassOf	cn:meat
cn:okra	rdfs:subClassOf	cn:vegetable
cn:fruit	cn:hasProperty	cn:opaque
cn:tiger_bread	rdfs:subClassOf	cn:food
cn:emirate	rdfs:subClassOf	cn:state
cn:eating_ice_cream	cn:usedFor	cn:dessert
cn:sandwich	rdfs:subClassOf	cn:snack_food
cn:gloeophyllales	rdfs:subClassOf	cn:fungus
cn:chytridiomycota_division	rdfs:subClassOf	cn:fungus
cn:pleurotus_ostreatus	rdfs:subClassOf	cn:fungus
cn:piece_of_coal	cn:usedFor	cn:decoration
cn:gift	rdfs:subClassOf	cn:object
cn:kaiser_roll	rdfs:subClassOf	cn:food
cn:poi	rdfs:subClassOf	cn:dish
cn:agnolotti	rdfs:subClassOf	cn:food
cn:helotiales	rdfs:subClassOf	cn:fungus
cn:pork_and_beans	rdfs:subClassOf	cn:dish
cn:edam_cheese	rdfs:subClassOf	cn:cheese
cn:diminishing_own_hunger	cn:hasPrerequisite	cn:food
cn:seed_leaf	rdfs:subClassOf	cn:leaf
cn:border	rdfs:subClassOf	cn:part
cn:living_thing	cn:capableOf	cn:experience_pain
cn:pita	rdfs:subClassOf	cn:food
cn:snowball	rdfs:subClassOf	cn:frozen_dessert
cn:fungus	rdfs:subClassOf	cn:eukaryotic_organism
cn:frittata	rdfs:subClassOf	cn:dish
cn:puccinia	rdfs:subClassOf	cn:fungus
cn:sand	rdfs:subClassOf	cn:color
cn:starches	rdfs:subClassOf	cn:foodstuff
cn:honey_mushroom	rdfs:subClassOf	cn:agaric
cn:bread_roll	cn:instanceOf	cn:bread
cn:sprout	rdfs:subClassOf	cn:vegetable
cn:liquid	cn:hasProperty	cn:subject_to_law_of_gravity
cn:lemon	rdfs:subClassOf	cn:yellow
cn:kokoretsi	rdfs:subClassOf	cn:food
cn:food	cn:capableOf	cn:cake_on_pans
cn:brunost	rdfs:subClassOf	cn:food
cn:fruit	cn:createdBy	cn:trees
cn:mushrooms_and_tomatoes	rdfs:subClassOf	cn:vegetables
cn:eat_in_restaurant	cn:motivatedByGoal	cn:food
cn:steak	rdfs:subClassOf	cn:food
cn:food	cn:hasProperty	cn:edible
cn:conchiglie	rdfs:subClassOf	cn:food
cn:cock_leekie	rdfs:subClassOf	cn:soup
cn:appenzeller_cheese	rdfs:subClassOf	cn:cheese
cn:lobularity	rdfs:subClassOf	cn:shape
cn:chocolate	cn:usedFor	cn:improve_mood
cn:solomon_gundy	rdfs:subClassOf	cn:food
cn:boston_cream_pie	cn:instanceOf	cn:dessert
cn:corn_flakes	rdfs:subClassOf	cn:food
cn:amanita_caesarea	rdfs:subClassOf	cn:fungus
cn:cheese	rdfs:subClassOf	cn:dairy_product
cn:state	cn:partOf	cn:united_states
cn:neapolitan_ice_cream	rdfs:subClassOf	cn:ice_cream
cn:beef_wellington	rdfs:subClassOf	cn:dish
cn:banana_bread	cn:instanceOf	cn:bread
cn:dog_food	rdfs:subClassOf	cn:food
cn:split_pea_soup	rdfs:subClassOf	cn:soup
cn:bubble_tea	rdfs:subClassOf	cn:food
cn:streuselkuchen	rdfs:subClassOf	cn:food
cn:coffee_cake	rdfs:subClassOf	cn:food
cn:cheese	cn:capableOf	cn:smell_badly
cn:carrot	rdfs:subClassOf	cn:vegetable
cn:cabbage	rdfs:subClassOf	cn:plant
cn:tricholoma_vaccinum	rdfs:subClassOf	cn:agaric
cn:bread	cn:capableOf	cn:rise_until_doubles_in_volume
cn:skin_color	rdfs:subClassOf	cn:color
cn:salad_bowl	rdfs:subClassOf	cn:dish
cn:pizza_hut	cn:dbpedia/product	cn:pizza
cn:cheese	rdfs:subClassOf	cn:tangible_thing
cn:bigoli	rdfs:subClassOf	cn:food
cn:krystal	cn:dbpedia/product	cn:hamburger
cn:food	cn:receivesAction	cn:eaten_from_plates
cn:hasenpfeffer	rdfs:subClassOf	cn:food
cn:louisana	rdfs:subClassOf	cn:state
cn:lamb_flesh	rdfs:subClassOf	cn:meat
cn:offspring	rdfs:subClassOf	cn:living_thing
cn:western	rdfs:subClassOf	cn:sandwich
cn:juice	cn:hasProperty	cn:liquid
cn:rug	cn:usedFor	cn:decoration
cn:leaf	cn:usedFor	cn:feed_to_worms
cn:vegetables	rdfs:subClassOf	cn:living_things
cn:chocolate	rdfs:subClassOf	cn:high_fat_food
cn:chip	rdfs:subClassOf	cn:snack_food
cn:barbados	rdfs:subClassOf	cn:state
cn:gluten_bread	rdfs:subClassOf	cn:bread
cn:convenience_food	rdfs:subClassOf	cn:food
cn:bottom_rot_fungus	rdfs:subClassOf	cn:fungus
cn:shaggymane	rdfs:subClassOf	cn:agaric
cn:chocolate	cn:capableOf	cn:make_happy
cn:gruel	rdfs:subClassOf	cn:food
cn:food	cn:receivesAction	cn:cooked_in_pan
cn:plantain	rdfs:subClassOf	cn:vegetable
cn:cone	rdfs:subClassOf	cn:shape
cn:refried_beans	rdfs:subClassOf	cn:dish
cn:jerky	rdfs:subClassOf	cn:meat
cn:cassava	rdfs:subClassOf	cn:vegetable
cn:haggis	rdfs:subClassOf	cn:food
cn:liquid	cn:capableOf	cn:boil
cn:hungry_person	cn:desires	cn:food
cn:bavarian_cream	rdfs:subClassOf	cn:food
cn:korma	rdfs:subClassOf	cn:dish
cn:tagliatelle	rdfs:subClassOf	cn:food
cn:halva	rdfs:subClassOf	cn:food
cn:food	cn:hasProperty	cn:necessary_to_sustain_life
cn:absinthe	rdfs:subClassOf	cn:green
cn:borsch	rdfs:subClassOf	cn:soup
cn:oxtail_soup	rdfs:subClassOf	cn:food
cn:cassoulet	rdfs:subClassOf	cn:food
cn:fruit	rdfs:subClassOf	cn:solid_object
cn:baking_oven	cn:usedFor	cn:bread
cn:tasting_sweet	cn:hasPrerequisite	cn:food
cn:thick_pizza	rdfs:subClassOf	cn:pizza
cn:turtle_soup	rdfs:subClassOf	cn:food
cn:simit	rdfs:subClassOf	cn:food
cn:kohlrabi	rdfs:subClassOf	cn:vegetable
cn:chicken_cordon_bleu	rdfs:subClassOf	cn:dish
cn:hamburger	cn:capableOf	cn:containe_ketchup
cn:region_of_england	rdfs:subClassOf	cn:state
cn:organism	cn:capableOf	cn:need
cn:meat	cn:usedFor	cn:butchering
cn:simit	cn:instanceOf	cn:bread
cn:island	rdfs:subClassOf	cn:state
cn:kroppkaka	rdfs:subClassOf	cn:food
cn:pholiota_nameko	rdfs:subClassOf	cn:fungus
cn:malawi	rdfs:subClassOf	cn:state
cn:chocolate	cn:createdBy	cn:mixing_sugar_cocoa_butter_and_cocoa_liquor
cn:pond_scum_parasite	rdfs:subClassOf	cn:fungus
cn:compound_leaf	rdfs:subClassOf	cn:leaf
cn:funnel_cake	rdfs:subClassOf	cn:food
cn:blt	rdfs:subClassOf	cn:food
cn:puree	rdfs:subClassOf	cn:nutriment
cn:eggplant	rdfs:subClassOf	cn:fruit
cn:phytophthora_infestans	rdfs:subClassOf	cn:fungus
cn:cheese	cn:partOf	cn:pizza
cn:pizza_sauce	cn:partOf	cn:pizza
cn:arkansas	rdfs:subClassOf	cn:state
cn:bread	cn:madeOf	cn:dough
cn:chocolate_ice_cream	cn:hasProperty	cn:delicious
cn:bread	rdfs:subClassOf	cn:starch
cn:toast	cn:madeOf	cn:bread
cn:gingerbread	rdfs:subClassOf	cn:food
cn:berry	rdfs:subClassOf	cn:fruit
cn:phytophthora_citrophthora	rdfs:subClassOf	cn:fungus
cn:diamond	cn:usedFor	cn:decoration
cn:boletaceae	rdfs:subClassOf	cn:fungus
cn:fish	rdfs:subClassOf	cn:food
cn:neolentinus	rdfs:subClassOf	cn:fungus
cn:living_thing	rdfs:subClassOf	cn:tangible_thing
cn:terrace_railing	cn:usedFor	cn:decoration
cn:crème_caramel	rdfs:subClassOf	cn:food
cn:salad_sandwich	rdfs:subClassOf	cn:sandwich
cn:bread	cn:hasProperty	cn:baked_in_oven
cn:nutella	rdfs:subClassOf	cn:food
cn:blueberry	rdfs:subClassOf	cn:fruit
cn:edible_mushroom_sandwich	rdfs:subClassOf	cn:sandwich
cn:cantharellus	rdfs:subClassOf	cn:fungus
cn:ricotta	rdfs:subClassOf	cn:cheese
cn:uzbek_state	rdfs:subClassOf	cn:state
cn:puffball	rdfs:subClassOf	cn:fungus
cn:sandwich	rdfs:subClassOf	cn:ready_to_eat_food
cn:montana	rdfs:subClassOf	cn:state
cn:ice_cream	rdfs:subClassOf	cn:popular_desert_topping
cn:fig	rdfs:subClassOf	cn:fruit
cn:fruit	cn:hasProperty	cn:rare_and_expensive_in_japan
cn:green_peppers	rdfs:subClassOf	cn:vegetables
cn:growing_vegetables	cn:causes	cn:vegetables
cn:broccoli	cn:hasProperty	cn:green
cn:zucchini	rdfs:subClassOf	cn:vegetable
cn:hot_table	cn:usedFor	cn:food
cn:waldorf_salad	rdfs:subClassOf	cn:food
cn:hydractinian	rdfs:subClassOf	cn:organism
cn:poultry	rdfs:subClassOf	cn:meat
cn:single_responsibility_principle	rdfs:subClassOf	cn:solid
cn:irish_county	rdfs:subClassOf	cn:state
cn:tremella_foliacea	rdfs:subClassOf	cn:fungus
cn:thukpa	rdfs:subClassOf	cn:food
cn:horse_mushroom	rdfs:subClassOf	cn:agaric
cn:laksa	rdfs:subClassOf	cn:food
cn:gravlax	rdfs:subClassOf	cn:food
cn:krumkake	rdfs:subClassOf	cn:food
cn:ring	cn:usedFor	cn:decoration
cn:summer_pudding	rdfs:subClassOf	cn:food
cn:soup	rdfs:subClassOf	cn:course
cn:caramel	rdfs:subClassOf	cn:food
cn:tortillas_and_bread	rdfs:subClassOf	cn:food
cn:har_gow	rdfs:subClassOf	cn:food
cn:montanna	rdfs:subClassOf	cn:state
cn:tiramisu	rdfs:subClassOf	cn:dessert
cn:pad	rdfs:subClassOf	cn:leaf
cn:chef_salad	rdfs:subClassOf	cn:food
cn:dushbara	rdfs:subClassOf	cn:food
cn:braunschweiger	rdfs:subClassOf	cn:food
cn:death_cap	rdfs:subClassOf	cn:agaric
cn:meat_sauce	rdfs:subClassOf	cn:pasta_sauce
cn:golden	cn:similarTo	cn:euphonious
cn:democrat	cn:similarTo	cn:green
cn:devil's_food_cake	rdfs:subClassOf	cn:food
cn:sashimi	rdfs:subClassOf	cn:dish
cn:clitocybe_subconnexa	rdfs:subClassOf	cn:agaric
cn:baguette	cn:instanceOf	cn:bread
cn:wild_cherry	rdfs:subClassOf	cn:fruit
cn:italian_region	rdfs:subClassOf	cn:state
cn:cornbread	rdfs:subClassOf	cn:food
cn:ice_cream	cn:hasProperty	cn:high_in_calories
cn:domestic_sheep_flesh	rdfs:subClassOf	cn:meat
cn:hard_sauce	cn:instanceOf	cn:dessert
cn:falafel	rdfs:subClassOf	cn:food
cn:syncytium	rdfs:subClassOf	cn:living_thing
cn:tree	cn:usedFor	cn:decoration
cn:muscle	cn:madeOf	cn:meat
cn:bap	rdfs:subClassOf	cn:bread
cn:aubergine	rdfs:subClassOf	cn:fruit
cn:vegetable	rdfs:subClassOf	cn:herb
cn:mouton	rdfs:subClassOf	cn:meat
cn:oyster_cracker	rdfs:subClassOf	cn:food
cn:egg_tart	cn:instanceOf	cn:dessert
cn:oval	rdfs:subClassOf	cn:geometrical_plane_figure
cn:galantine	rdfs:subClassOf	cn:dish
cn:blue_cheese	rdfs:subClassOf	cn:cheese
cn:food	cn:receivesAction	cn:cooked_on_grill
cn:leaf	cn:partOf	cn:plant
cn:food	rdfs:subClassOf	cn:fuel_for_people
cn:general_tso's_chicken	rdfs:subClassOf	cn:food
cn:kosher_deli_might	cn:hasA	cn:food
cn:ice_cream	cn:capableOf	cn:taste_sweet
cn:tricholoma_aurantium	rdfs:subClassOf	cn:agaric
cn:hat	cn:usedFor	cn:decoration
cn:pale_yellow	rdfs:subClassOf	cn:yellow
cn:meat	cn:receivesAction	cn:served_at_steakhouse
cn:veluticeps	rdfs:subClassOf	cn:fungus
cn:gazpacho	rdfs:subClassOf	cn:soup
cn:auriscalpium	rdfs:subClassOf	cn:fungus
cn:food	cn:definedAs	cn:priority_industry
cn:timbale	rdfs:subClassOf	cn:dish
cn:thin_pizza	rdfs:subClassOf	cn:pizza
cn:ice_cream_sundae	rdfs:subClassOf	cn:frozen_dessert
cn:liquid	rdfs:subClassOf	cn:state_of_mater
cn:get	cn:hasPrerequisite	cn:produce
cn:cheeseburger	rdfs:subClassOf	cn:cheese_sandwich
cn:food	cn:usedFor	cn:eating
cn:beanie_baby	cn:usedFor	cn:decoration
cn:aureolin_thing	rdfs:subClassOf	cn:yellow
cn:pink	rdfs:subClassOf	cn:colored_thing
cn:polyporaceae	rdfs:subClassOf	cn:fungus
cn:tapenade	rdfs:subClassOf	cn:food
cn:esterházy_torte	rdfs:subClassOf	cn:food
cn:green	rdfs:subClassOf	cn:political_perspective
cn:agaricus	rdfs:subClassOf	cn:fungus
cn:pappardelle	rdfs:subClassOf	cn:food
cn:sausage	rdfs:subClassOf	cn:food
cn:dart	rdfs:subClassOf	cn:object
cn:skilandis	rdfs:subClassOf	cn:food
cn:austrian_state	rdfs:subClassOf	cn:state
cn:meat	cn:usedFor	cn:feed_dog
cn:fruit	cn:hasA	cn:vitamins
cn:spaghetti	rdfs:subClassOf	cn:food
cn:salad	cn:hasProperty	cn:green
cn:groom's_cake	rdfs:subClassOf	cn:food
cn:vol_au_vent	rdfs:subClassOf	cn:food
cn:historic_english_county	rdfs:subClassOf	cn:state
cn:gyromitra	rdfs:subClassOf	cn:fungus
cn:apples_and_lizards	cn:hasProperty	cn:yellow
cn:bubble_and_squeak	rdfs:subClassOf	cn:dish
cn:curry	rdfs:subClassOf	cn:food
cn:curry	rdfs:subClassOf	cn:dish
cn:banana	cn:instanceOf	cn:fruit
cn:chocolate	cn:receivesAction	cn:melted
cn:rwanda	rdfs:subClassOf	cn:state
cn:object	cn:capableOf	cn:fall_inside_or_outside_frame
cn:living_life	cn:hasPrerequisite	cn:food
cn:bruschetta	rdfs:subClassOf	cn:food
cn:leaf	cn:usedFor	cn:turning_colour_in_autumn
cn:kentucky	rdfs:subClassOf	cn:state
cn:lobster_thermidor	rdfs:subClassOf	cn:dish
cn:dikarya	rdfs:subClassOf	cn:fungus
cn:quesadilla	rdfs:subClassOf	cn:burrito
cn:cheese	cn:receivesAction	cn:bought_in_store
cn:lettuce	cn:partOf	cn:garden_lettuce
cn:living_organism	rdfs:subClassOf	cn:living_thing
cn:grey	rdfs:subClassOf	cn:color
cn:plum_tomato	rdfs:subClassOf	cn:fruit
cn:vegetable	rdfs:subClassOf	cn:food
cn:living_thing	rdfs:subClassOf	cn:fixed_functional_system
cn:old_gold	rdfs:subClassOf	cn:yellow
cn:cooking	cn:hasPrerequisite	cn:food
cn:afikoman	cn:instanceOf	cn:dessert
cn:cheese	rdfs:subClassOf	cn:dairy_product_from_cows
cn:meal	rdfs:subClassOf	cn:foodstuff
cn:buffet	cn:usedFor	cn:food
cn:meat_sausage	rdfs:subClassOf	cn:sausage
cn:strawberry	cn:dbpedia/genus	cn:fragaria
cn:cortinarius_violaceus	rdfs:subClassOf	cn:agaric
cn:ice_cream_sandwich	rdfs:subClassOf	cn:sandwich
cn:auriculariales	rdfs:subClassOf	cn:fungus
cn:basic_tenets_of_global_warming	cn:hasProperty	cn:solid
cn:food	cn:receivesAction	cn:found_in_oven
cn:sausage	cn:usedFor	cn:cooking_and_eating
cn:beer_soup	rdfs:subClassOf	cn:food
cn:sisal_leaf	rdfs:subClassOf	cn:leaf
cn:butterhead_lettuce	rdfs:subClassOf	cn:lettuce
cn:county	rdfs:subClassOf	cn:state
cn:matter	cn:madeOf	cn:molecules
cn:debrecener	rdfs:subClassOf	cn:food
cn:meat	cn:definedAs	cn:flesh_of_animal
cn:mold	rdfs:subClassOf	cn:fungus
cn:pumpernickel	rdfs:subClassOf	cn:food
cn:vanilla_bean	rdfs:subClassOf	cn:fruit
cn:pholiota_astragalina	rdfs:subClassOf	cn:agaric
cn:meat	rdfs:subClassOf	cn:muscle
cn:contest_shape	rdfs:subClassOf	cn:shape
cn:sliced_bread	cn:instanceOf	cn:bread
cn:meat	cn:receivesAction	cn:found_in_steak_hous
cn:leaf	rdfs:subClassOf	cn:part_of_tree
cn:caraway_seed_bread	rdfs:subClassOf	cn:bread
cn:bread	cn:capableOf	cn:raise_while_cooks
cn:bread_roll	rdfs:subClassOf	cn:food
cn:domesticated_pig_flesh	rdfs:subClassOf	cn:meat
cn:neocallimastigomycota	rdfs:subClassOf	cn:fungus
cn:chip_sandwich	rdfs:subClassOf	cn:sandwich
cn:bovine_calf_meat	rdfs:subClassOf	cn:meat
cn:potato	rdfs:subClassOf	cn:starches
cn:manna	cn:instanceOf	cn:bread
cn:antigua_and_barbuda	rdfs:subClassOf	cn:state
cn:bisque	rdfs:subClassOf	cn:soup
cn:liquid	cn:similarTo	cn:disposable
cn:united_kingdom	rdfs:subClassOf	cn:state
cn:organism	cn:partOf	cn:ecosystem
cn:fistulinaceae	rdfs:subClassOf	cn:fungus
cn:mousse	rdfs:subClassOf	cn:food
cn:ice_pop	cn:instanceOf	cn:frozen_dessert
cn:acid	rdfs:subClassOf	cn:liquid
cn:sarcoscypha_coccinea	rdfs:subClassOf	cn:fungus
cn:macedoine	rdfs:subClassOf	cn:dish
cn:peas	cn:hasProperty	cn:green
cn:malta	rdfs:subClassOf	cn:state
cn:most_televisions_sold_today	cn:hasProperty	cn:color
cn:frangipane	rdfs:subClassOf	cn:food
cn:spectral_color	rdfs:subClassOf	cn:color
cn:carpaccio	rdfs:subClassOf	cn:food
cn:cheddar_cheese	rdfs:subClassOf	cn:cheese
cn:dish	cn:usedFor	cn:serving_food
cn:borscht	rdfs:subClassOf	cn:food
cn:ocean	rdfs:subClassOf	cn:liquid
cn:meat	cn:receivesAction	cn:cooked_on_grill
cn:object	cn:capableOf	cn:disappear_from_sight
cn:idli	rdfs:subClassOf	cn:food
cn:orecchiette	rdfs:subClassOf	cn:food
cn:pseudallescheria	rdfs:subClassOf	cn:fungus
cn:rhodotorula	rdfs:subClassOf	cn:fungus
cn:eating_hamburger	cn:hasPrerequisite	cn:hamburger
cn:soup	cn:partOf	cn:meal
cn:fish_stick	rdfs:subClassOf	cn:dish
cn:agaricales	rdfs:subClassOf	cn:fungus
cn:fruit	cn:receivesAction	cn:made_into_jams
cn:vatrushka	rdfs:subClassOf	cn:food
cn:angularity	rdfs:subClassOf	cn:shape
cn:pink	rdfs:subClassOf	cn:pinkish_thing
cn:campbell_soup	rdfs:subClassOf	cn:soup
cn:dundee_cake	rdfs:subClassOf	cn:food
cn:loaf_of_bread	rdfs:subClassOf	cn:bread
cn:fig_leaf	rdfs:subClassOf	cn:leaf
cn:potato_wart_fungus	rdfs:subClassOf	cn:fungus
cn:indiana	rdfs:subClassOf	cn:state
cn:tree	cn:usedFor	cn:fruit
cn:bovine_calf_flesh	rdfs:subClassOf	cn:meat
cn:turrón	rdfs:subClassOf	cn:food
cn:fungus	rdfs:subClassOf	cn:organism
cn:dog	cn:desires	cn:meat
cn:tasting_sweet	cn:usedFor	cn:dessert
cn:compote	cn:instanceOf	cn:dessert
cn:gamboge	rdfs:subClassOf	cn:yellow
cn:chistorra	rdfs:subClassOf	cn:food
cn:cheese_slice	rdfs:subClassOf	cn:cheese
cn:yellow_stop_sign	rdfs:subClassOf	cn:yellow
cn:koeksister	rdfs:subClassOf	cn:food
cn:doughnut	rdfs:subClassOf	cn:food
cn:chard	rdfs:subClassOf	cn:vegetable
cn:eparchy	rdfs:subClassOf	cn:state
cn:hawaiian_pizza	rdfs:subClassOf	cn:pizza
cn:schoolbuses	cn:hasProperty	cn:yellow
cn:bromine	rdfs:subClassOf	cn:liquid
cn:anchovy_pizza	rdfs:subClassOf	cn:pizza
cn:organs	cn:partOf	cn:organism
cn:chrome_green	rdfs:subClassOf	cn:green
cn:blewits	rdfs:subClassOf	cn:agaric
cn:russula	rdfs:subClassOf	cn:fungus
cn:meat	cn:usedFor	cn:chefs_to_cook
cn:bright_color	rdfs:subClassOf	cn:color
cn:tomato_and_lettuce_sandwich	rdfs:subClassOf	cn:sandwich
cn:stropharia_hornemannii	rdfs:subClassOf	cn:agaric
cn:meat	cn:usedFor	cn:make_meal
cn:hamburger	cn:similarTo	cn:pork_burger
cn:frogs	cn:hasProperty	cn:green
cn:solferino	rdfs:subClassOf	cn:pink
cn:chain	cn:usedFor	cn:decoration
cn:shiitake	rdfs:subClassOf	cn:fungus
cn:b_roll	cn:similarTo	cn:roll
cn:frog	cn:hasProperty	cn:green
cn:healthy_dinner	cn:hasA	cn:vegetables
cn:dish	cn:usedFor	cn:having_dinner
cn:north_dakota	rdfs:subClassOf	cn:state
cn:new_york_style_pizza	rdfs:subClassOf	cn:pizza
cn:fruit	rdfs:subClassOf	cn:reproductive_structure
cn:liquefiable	cn:similarTo	cn:liquid
cn:tortilla_chip	cn:instanceOf	cn:snack_food
cn:beet	rdfs:subClassOf	cn:vegetable
cn:battenberg_cake	rdfs:subClassOf	cn:food
cn:pizza	rdfs:subClassOf	cn:popular_food
cn:horse_flesh	rdfs:subClassOf	cn:meat
cn:piece_de_resistance	rdfs:subClassOf	cn:dish
cn:polyporus_squamosus	rdfs:subClassOf	cn:fungus
cn:dish	cn:usedFor	cn:eat_things_off_of
cn:clubroot_fungus	rdfs:subClassOf	cn:fungus
cn:food	cn:capableOf	cn:tastes_better_with_salt
cn:eggplant	rdfs:subClassOf	cn:vegetable
cn:toadstool	rdfs:subClassOf	cn:mushroom
cn:cameroon	rdfs:subClassOf	cn:state
cn:waiting_on_tables	cn:usedFor	cn:food
cn:pizza_toppings	cn:partOf	cn:pizza
cn:eating_breakfast_in_bed	cn:hasPrerequisite	cn:food
cn:pink	rdfs:subClassOf	cn:pastel_color
cn:achene	rdfs:subClassOf	cn:fruit
cn:scallion_pancake	rdfs:subClassOf	cn:food
cn:sorbet	rdfs:subClassOf	cn:food
cn:food	cn:capableOf	cn:rots_with_age
cn:go_to_restaurant	cn:motivatedByGoal	cn:hamburger
cn:pheasant_under_glass	rdfs:subClassOf	cn:dish
cn:beef_burrito	rdfs:subClassOf	cn:burrito
cn:yellow	cn:definedAs	cn:colour_of_cowardice
cn:yorkshire_pudding	rdfs:subClassOf	cn:food
cn:dish	cn:usedFor	cn:serving_liquid
cn:ice	cn:hasProperty	cn:solid
cn:bisque	cn:instanceOf	cn:soup
cn:delaware	rdfs:subClassOf	cn:state
cn:lychee	rdfs:subClassOf	cn:fruit
cn:waffle	rdfs:subClassOf	cn:food
cn:brioche	cn:instanceOf	cn:dessert
cn:cordon_bleu	rdfs:subClassOf	cn:food
cn:challah	cn:instanceOf	cn:bread
cn:macaroni	rdfs:subClassOf	cn:food
cn:pancetta	rdfs:subClassOf	cn:food
cn:sandwich	cn:receivesAction	cn:found_in_deli
cn:corn_bread	rdfs:subClassOf	cn:bread
cn:liquid	rdfs:subClassOf	cn:more_common_word_than_fluid
cn:emarginate_leaf	rdfs:subClassOf	cn:leaf
cn:dobos_torte	rdfs:subClassOf	cn:food
cn:apple	rdfs:subClassOf	cn:fruit
cn:salt	cn:usedFor	cn:food
cn:pluteus_cervinus	rdfs:subClassOf	cn:fungus
cn:limburger	rdfs:subClassOf	cn:cheese
cn:caerphilly	rdfs:subClassOf	cn:cheese
cn:broccoli	rdfs:subClassOf	cn:cruciferous_vegetable
cn:bacon_lettuce_tomato_sandwich	rdfs:subClassOf	cn:sandwich
cn:vegetables	cn:hasProperty	cn:green
cn:string_cheese	rdfs:subClassOf	cn:cheese
cn:parsley_leaf	rdfs:subClassOf	cn:leaf
cn:custard	rdfs:subClassOf	cn:food
cn:deli_slice	rdfs:subClassOf	cn:meat
cn:eukaryote	rdfs:subClassOf	cn:organism
cn:shellfish_flesh	rdfs:subClassOf	cn:meat
cn:food	cn:capableOf	cn:mean_which_one_feeds_on
cn:ciabatta	rdfs:subClassOf	cn:bread
cn:salmon_loaf	rdfs:subClassOf	cn:fish_loaf
cn:meat	cn:usedFor	cn:people_to_eat
cn:gloeophyllum	rdfs:subClassOf	cn:fungus
cn:italian_ice	cn:instanceOf	cn:dessert
cn:st_andre_cheese	rdfs:subClassOf	cn:cheese
cn:ingredient	cn:partOf	cn:mixture
cn:head_cabbage	rdfs:subClassOf	cn:cabbage
cn:ragout	rdfs:subClassOf	cn:food
cn:soybean	rdfs:subClassOf	cn:vegetable
cn:pla_ra	rdfs:subClassOf	cn:food
cn:one_unhealthy_food	cn:hasProperty	cn:chocolate
cn:sating_hunger	cn:hasPrerequisite	cn:food
cn:wynnea_sparassoides	rdfs:subClassOf	cn:fungus
cn:fly_agaric	rdfs:subClassOf	cn:agaric
cn:fusarium	rdfs:subClassOf	cn:fungus
cn:ohio	rdfs:subClassOf	cn:state
cn:nasi_goreng	rdfs:subClassOf	cn:food
cn:cucumber	cn:dbpedia/genus	cn:cucumis
cn:cranberries	cn:hasProperty	cn:purple
cn:oil	rdfs:subClassOf	cn:liquid
cn:plate	rdfs:subClassOf	cn:dish
cn:prickly_edged_leaf	rdfs:subClassOf	cn:leaf
cn:bread	cn:hasProperty	cn:baked_at_bakery
cn:bread	cn:madeOf	cn:wheat
cn:flower	cn:hasProperty	cn:solid
cn:vanilla_ice_cream	rdfs:subClassOf	cn:ice_cream
cn:reddish_purple	rdfs:subClassOf	cn:purple
cn:banana_split	cn:instanceOf	cn:dessert
cn:furniture_secretary	cn:usedFor	cn:decoration
cn:white_grape	rdfs:subClassOf	cn:fruit
cn:treccione_cheese	rdfs:subClassOf	cn:cheese
cn:zabaione	rdfs:subClassOf	cn:food
cn:steak_and_tortillas	rdfs:subClassOf	cn:food
cn:jazz_apple	rdfs:subClassOf	cn:fruit
cn:dacquoise	cn:instanceOf	cn:dessert
cn:vermont	rdfs:subClassOf	cn:state
cn:new_mexico	rdfs:subClassOf	cn:state
cn:chicken_and_rice	rdfs:subClassOf	cn:dish
cn:gymnopilus_spectabilis	rdfs:subClassOf	cn:agaric
cn:ploughman's_lunch	rdfs:subClassOf	cn:food
cn:bread	cn:hasProperty	cn:rising_while_bakes
cn:eating_dinner	cn:hasPrerequisite	cn:food
cn:lawn	cn:hasProperty	cn:green
cn:mauritius	rdfs:subClassOf	cn:state
cn:nougat	rdfs:subClassOf	cn:food
cn:choker	cn:usedFor	cn:decoration
cn:decoy	rdfs:subClassOf	cn:object
cn:bánh_mì	cn:instanceOf	cn:bread
cn:compote	rdfs:subClassOf	cn:dessert
cn:rosette	rdfs:subClassOf	cn:leaf
cn:spaghetti_and_meatballs	rdfs:subClassOf	cn:dish
cn:equatorial_guinea	rdfs:subClassOf	cn:state
cn:enchilada	rdfs:subClassOf	cn:dish
cn:onygenales	rdfs:subClassOf	cn:fungus
cn:rösti	rdfs:subClassOf	cn:food
cn:meat	rdfs:subClassOf	cn:what_get_from_lobster
cn:pistou	rdfs:subClassOf	cn:food
cn:food	cn:capableOf	cn:cost_money
cn:mousse	rdfs:subClassOf	cn:dish
cn:zabaglione	rdfs:subClassOf	cn:dessert
cn:ramen	rdfs:subClassOf	cn:food
cn:region	rdfs:subClassOf	cn:state
cn:fruit	cn:hasA	cn:sugar
cn:abgoosht	rdfs:subClassOf	cn:food
cn:summer_in_basket_where	cn:definedAs	cn:green
cn:earthstar	rdfs:subClassOf	cn:fungus
cn:food	cn:partOf	cn:food
cn:products	rdfs:subClassOf	cn:food
cn:waxycap	rdfs:subClassOf	cn:agaric
cn:cretons	rdfs:subClassOf	cn:food
cn:blt	rdfs:subClassOf	cn:sandwich
cn:frank	rdfs:subClassOf	cn:sausage
cn:food	cn:receivesAction	cn:served_in_restaurant
cn:soviets	rdfs:subClassOf	cn:state
cn:okra	rdfs:subClassOf	cn:fruit
cn:amanita_phalloides	rdfs:subClassOf	cn:fungus
cn:bagel	rdfs:subClassOf	cn:bread
cn:charlotte	rdfs:subClassOf	cn:dessert
cn:ascomycete	rdfs:subClassOf	cn:fungus
cn:phallaceae	rdfs:subClassOf	cn:fungus
cn:food	cn:hasProperty	cn:spicy
cn:bavette	rdfs:subClassOf	cn:food
cn:blood_sausage	rdfs:subClassOf	cn:sausage
cn:one_apple	rdfs:subClassOf	cn:object
cn:oliebol	rdfs:subClassOf	cn:food
cn:concentrate	rdfs:subClassOf	cn:foodstuff
cn:pen	cn:hasProperty	cn:solid
cn:potato_bread	rdfs:subClassOf	cn:food
cn:french_toast	rdfs:subClassOf	cn:dish
cn:grub	rdfs:subClassOf	cn:living_thing
cn:cucumber	rdfs:subClassOf	cn:cool_crisp_vegetable
cn:lentinellus	rdfs:subClassOf	cn:fungus
cn:bosna	rdfs:subClassOf	cn:food
cn:choc_ice	rdfs:subClassOf	cn:chocolate_ice_cream
cn:trifle	cn:instanceOf	cn:dessert
cn:liquid	cn:similarTo	cn:semiliquid
cn:cobnut	rdfs:subClassOf	cn:fruit
cn:hygrophorus_purpurascens	rdfs:subClassOf	cn:fungus
cn:life_form	cn:desires	cn:food
cn:turnip_green	rdfs:subClassOf	cn:vegetable
cn:ice_cream	rdfs:subClassOf	cn:cold_dessert
cn:pholiota_squarrosa_adiposa	rdfs:subClassOf	cn:agaric
cn:at_body_temperature_water	cn:hasProperty	cn:liquid
cn:florida	rdfs:subClassOf	cn:state
cn:pepperoni	rdfs:subClassOf	cn:salami
cn:olive	rdfs:subClassOf	cn:color
cn:genetically_engineered_organism	rdfs:subClassOf	cn:living_thing
cn:bean	rdfs:subClassOf	cn:vegetable
cn:bánh_mì	rdfs:subClassOf	cn:food
cn:balalaika	cn:hasProperty	cn:triangular
cn:mushroom	rdfs:subClassOf	cn:fungus
cn:romano_cheese	rdfs:subClassOf	cn:cheese
cn:venation	cn:partOf	cn:leaf
cn:ribbon	rdfs:subClassOf	cn:decoration
cn:curd	rdfs:subClassOf	cn:foodstuff
cn:dish	cn:usedFor	cn:transporting_food
cn:gugelhupf	rdfs:subClassOf	cn:food
cn:most_leaves	cn:hasProperty	cn:green
cn:bosna	cn:instanceOf	cn:sandwich
cn:hair_clip	cn:usedFor	cn:decoration
cn:bitok	rdfs:subClassOf	cn:dish
cn:groom's_cake	cn:instanceOf	cn:dessert
cn:state	rdfs:subClassOf	cn:government
cn:cendol	rdfs:subClassOf	cn:food
cn:leaf	cn:capableOf	cn:fall_from_tree
cn:collard_greens	rdfs:subClassOf	cn:vegetable
cn:dumpling	rdfs:subClassOf	cn:dessert
cn:drupe	rdfs:subClassOf	cn:fruit
cn:pitcher	rdfs:subClassOf	cn:leaf
cn:bacteria	rdfs:subClassOf	cn:organism
cn:couverture	rdfs:subClassOf	cn:chocolate
cn:hanger_steak	rdfs:subClassOf	cn:food
cn:pho	rdfs:subClassOf	cn:food
cn:daube	rdfs:subClassOf	cn:food
cn:shashlik	rdfs:subClassOf	cn:food
cn:appetizer	rdfs:subClassOf	cn:course
cn:tajine	rdfs:subClassOf	cn:food
cn:xanthoria_parietina	rdfs:subClassOf	cn:fungus
cn:meal	rdfs:subClassOf	cn:nutriment
cn:fruit	cn:usedFor	cn:making_into_juice_drink
cn:currywurst	rdfs:subClassOf	cn:food
cn:flan	rdfs:subClassOf	cn:dessert
cn:rectangle	rdfs:subClassOf	cn:shape
cn:pho	rdfs:subClassOf	cn:soup
cn:fruit	cn:usedFor	cn:make_wine
cn:lobster_meat	rdfs:subClassOf	cn:meat
cn:chromatic	cn:similarTo	cn:buff
cn:greenishness	rdfs:subClassOf	cn:green
cn:tapas	rdfs:subClassOf	cn:food
cn:food	cn:capableOf	cn:please_hungry_person
cn:leaf	cn:usedFor	cn:photosynthesis
cn:bratwurst	rdfs:subClassOf	cn:food
cn:green	cn:hasProperty	cn:yellow
cn:pepper	rdfs:subClassOf	cn:fruit
cn:rijsttaffel	rdfs:subClassOf	cn:dish
cn:dainty	rdfs:subClassOf	cn:nutriment
cn:brazilian_state	rdfs:subClassOf	cn:state
cn:apple	cn:usedFor	cn:dessert
cn:wheel	rdfs:subClassOf	cn:object
cn:prefecture	rdfs:subClassOf	cn:state
cn:shape	rdfs:subClassOf	cn:spatial_property
cn:liquid	rdfs:subClassOf	cn:substance
cn:false_truffle	rdfs:subClassOf	cn:fungus
cn:stuffed_peppers	rdfs:subClassOf	cn:dish
cn:vitamin	rdfs:subClassOf	cn:nutriment
cn:frumenty	rdfs:subClassOf	cn:food
cn:tortelloni	rdfs:subClassOf	cn:food
cn:rock_candy	rdfs:subClassOf	cn:food
cn:freekeh	rdfs:subClassOf	cn:food
cn:soup	cn:madeOf	cn:water
cn:food	cn:receivesAction	cn:eatin
cn:tobacco_leaf	rdfs:subClassOf	cn:leaf
cn:fruit	cn:capableOf	cn:keep_fresh
cn:mustard_greens	rdfs:subClassOf	cn:vegetables
cn:nutmeg_fruit	rdfs:subClassOf	cn:fruit
cn:soup	rdfs:subClassOf	cn:light_meal
cn:feijoada	rdfs:subClassOf	cn:food
cn:sobrassada	cn:instanceOf	cn:sausage
cn:cheshire_cheese	rdfs:subClassOf	cn:cheese
cn:living_thing	rdfs:subClassOf	cn:spatially_bounded_thing
cn:yellow_submarine	rdfs:subClassOf	cn:yellow
cn:bread	cn:createdBy	cn:baker
cn:parfait	rdfs:subClassOf	cn:food
cn:circumscribiption	rdfs:subClassOf	cn:state
cn:food	rdfs:subClassOf	cn:what_people_eat
cn:fungus	cn:hasProperty	cn:almost_as_unpleasant_as_paying_taxes
cn:candida	rdfs:subClassOf	cn:fungus
cn:food	rdfs:subClassOf	cn:fuel
cn:variety_meat	rdfs:subClassOf	cn:meat
cn:chicken_paprika	rdfs:subClassOf	cn:dish
cn:pastilla	rdfs:subClassOf	cn:food
cn:animals	rdfs:subClassOf	cn:food
cn:pholiota_squarrosa	rdfs:subClassOf	cn:agaric
cn:olivier_salad	rdfs:subClassOf	cn:food
cn:scotch_woodcock	rdfs:subClassOf	cn:dish
cn:canary_yellow	rdfs:subClassOf	cn:yellow
cn:united_kingdom_of_great_britain_and_northern_ireland	rdfs:subClassOf	cn:state
cn:tortilla	rdfs:subClassOf	cn:unleavened_bread
cn:amanita_verna	rdfs:subClassOf	cn:fungus
cn:american_parasol	rdfs:subClassOf	cn:lepiota
cn:cryptococcus_neoformans	rdfs:subClassOf	cn:fungus
cn:berliner	rdfs:subClassOf	cn:food
cn:person	cn:desires	cn:hamburger
cn:sukiyaki	cn:instanceOf	cn:soup
cn:buying_fresh_fruits_and_vegetables	cn:usedFor	cn:food
cn:mint	rdfs:subClassOf	cn:leaf
cn:cheddar_pink	rdfs:subClassOf	cn:pink
cn:antipasto	rdfs:subClassOf	cn:food
cn:yellow_spot_fungus	rdfs:subClassOf	cn:fungus
cn:scone	rdfs:subClassOf	cn:food
cn:potatoes	rdfs:subClassOf	cn:vegetables
cn:pupusa	rdfs:subClassOf	cn:food
cn:lepiota	rdfs:subClassOf	cn:agaric
cn:alligator_pear	rdfs:subClassOf	cn:living_thing
cn:flax_fruit	rdfs:subClassOf	cn:fruit
cn:meat	cn:usedFor	cn:fuel
cn:braeburn_apple	rdfs:subClassOf	cn:fruit
cn:wisconsin	rdfs:subClassOf	cn:state
cn:purple	rdfs:subClassOf	cn:colour
cn:light_color	rdfs:subClassOf	cn:color
cn:ice_cream	rdfs:subClassOf	cn:frozen_dairy_treat
cn:fairy_bread	rdfs:subClassOf	cn:food
cn:dish	cn:usedFor	cn:eat
cn:sate_hunger	cn:motivatedByGoal	cn:food
cn:insects	cn:hasProperty	cn:green
cn:pastiera	rdfs:subClassOf	cn:food
cn:mexican	rdfs:subClassOf	cn:food
cn:wood	rdfs:subClassOf	cn:solid
cn:salisbury_steak	rdfs:subClassOf	cn:food
cn:cat_tongue	rdfs:subClassOf	cn:food
cn:fruit	rdfs:subClassOf	cn:healthy_source_of_food
cn:cell	cn:partOf	cn:organism
cn:shark_fin_soup	cn:instanceOf	cn:soup
cn:beer_soup	cn:instanceOf	cn:soup
cn:malabar	rdfs:subClassOf	cn:food
cn:sour_bread	rdfs:subClassOf	cn:bread
cn:cube	rdfs:subClassOf	cn:shape
cn:butter_chicken	rdfs:subClassOf	cn:food
cn:most_grass	cn:hasProperty	cn:green
cn:coccidioides_posadasii	rdfs:subClassOf	cn:fungus
cn:entolomataceae	rdfs:subClassOf	cn:fungus
cn:green	rdfs:subClassOf	cn:colour_of_rainbow
cn:camembert	rdfs:subClassOf	cn:cheese
cn:praline	rdfs:subClassOf	cn:food
cn:lobe	cn:partOf	cn:leaf
cn:cheese	rdfs:subClassOf	cn:food_and_cook_food
cn:weeds	cn:hasProperty	cn:green
cn:bouillabaisse	rdfs:subClassOf	cn:food
cn:yolk	rdfs:subClassOf	cn:yellow
cn:ground_meat	rdfs:subClassOf	cn:meat
cn:pea_soup	rdfs:subClassOf	cn:food
cn:color	rdfs:subClassOf	cn:visual_property
cn:mushroom	rdfs:subClassOf	cn:agaric
cn:nan	rdfs:subClassOf	cn:bread
cn:nuts	rdfs:subClassOf	cn:foodstuff
cn:jonathan	rdfs:subClassOf	cn:fruit
cn:potherb	rdfs:subClassOf	cn:vegetable
cn:chinese_food_often	cn:hasA	cn:meat
cn:flower	rdfs:subClassOf	cn:living_thing
cn:fufu	rdfs:subClassOf	cn:food
cn:cauliflower	rdfs:subClassOf	cn:vegetable
cn:toadstool	rdfs:subClassOf	cn:toxic_substance
cn:bobotie	rdfs:subClassOf	cn:food
cn:loaf	rdfs:subClassOf	cn:food
cn:gherkin	rdfs:subClassOf	cn:pickle
cn:chocolate	rdfs:subClassOf	cn:food
cn:summer_pudding	cn:instanceOf	cn:dessert
cn:stocking_cap	rdfs:subClassOf	cn:cap
cn:corn_borer	cn:hasProperty	cn:pink
cn:element	rdfs:subClassOf	cn:substance
cn:violet	rdfs:subClassOf	cn:purple
cn:cardoon	rdfs:subClassOf	cn:vegetable
cn:utah	rdfs:subClassOf	cn:state
cn:toast	cn:instanceOf	cn:bread
cn:shark_fin_soup	rdfs:subClassOf	cn:food
cn:fish_and_chips	rdfs:subClassOf	cn:food
cn:pineapple_cake	cn:instanceOf	cn:dessert
cn:potatoes_and_chicken	rdfs:subClassOf	cn:food
cn:souffle	rdfs:subClassOf	cn:dish
cn:clathrus	rdfs:subClassOf	cn:fungus
cn:hamburger	cn:madeOf	cn:wheat
cn:dika_bread	rdfs:subClassOf	cn:food
cn:food	cn:capableOf	cn:spilt_on_tablecloth
cn:olive	rdfs:subClassOf	cn:fruit
cn:daffodils_flowers	cn:hasProperty	cn:yellow
cn:jade	cn:hasProperty	cn:green
cn:food	cn:capableOf	cn:matter_more_than_sex
cn:narrowing	rdfs:subClassOf	cn:shape
cn:blintz	rdfs:subClassOf	cn:food
cn:meadow_mushroom	rdfs:subClassOf	cn:agaric
cn:bread	cn:usedFor	cn:baking
cn:jicama	rdfs:subClassOf	cn:vegetable
cn:tar	rdfs:subClassOf	cn:substance
cn:kazakh_state	rdfs:subClassOf	cn:state
cn:pancake	rdfs:subClassOf	cn:food
cn:polenta	rdfs:subClassOf	cn:food
cn:bulgaria	rdfs:subClassOf	cn:state
cn:bovine_flesh	rdfs:subClassOf	cn:meat
cn:meat	rdfs:subClassOf	cn:in_chinese_food
cn:meat	rdfs:subClassOf	cn:food
cn:granita	rdfs:subClassOf	cn:food
cn:pyxidium	rdfs:subClassOf	cn:fruit
cn:beef_stroganoff	rdfs:subClassOf	cn:dish
cn:artichoke	rdfs:subClassOf	cn:vegetable
cn:egg_salad	rdfs:subClassOf	cn:food
cn:minnesota	rdfs:subClassOf	cn:state
cn:truffle	rdfs:subClassOf	cn:fungus
cn:lobed_leaf	rdfs:subClassOf	cn:leaf
cn:amok	rdfs:subClassOf	cn:food
cn:fondue	rdfs:subClassOf	cn:dish
cn:monkey_bread	cn:instanceOf	cn:bread
cn:momo	rdfs:subClassOf	cn:food
cn:many_vegetables	cn:hasProperty	cn:green
cn:pozole	cn:instanceOf	cn:soup
cn:district	rdfs:subClassOf	cn:state
cn:dish	cn:usedFor	cn:hold_food
cn:fruit	rdfs:subClassOf	cn:rigid_portable_object
cn:tomato_sauce	cn:similarTo	cn:meat_sauce
cn:matter	cn:hasA	cn:three_states
cn:rice_and_pasta	rdfs:subClassOf	cn:food
cn:cooking	cn:causes	cn:food
cn:juniper_berry	rdfs:subClassOf	cn:fruit
cn:ice_cream_cone	rdfs:subClassOf	cn:frozen_dessert
cn:state	cn:madeOf	cn:counties
cn:empanada	rdfs:subClassOf	cn:food
cn:carbonara	rdfs:subClassOf	cn:food
cn:parmigiana	rdfs:subClassOf	cn:food
cn:raw_foodism	rdfs:subClassOf	cn:food
cn:car	cn:hasProperty	cn:green
cn:eel	rdfs:subClassOf	cn:meat
cn:bread	cn:usedFor	cn:tearing
cn:sunflowers	cn:hasProperty	cn:yellow
cn:cylinder	rdfs:subClassOf	cn:shape
cn:ghana	rdfs:subClassOf	cn:state
cn:deer_mushroom	rdfs:subClassOf	cn:agaric
cn:color	cn:hasProperty	cn:more_colorful_with_low_value_contrast
cn:everything	cn:madeOf	cn:matter
cn:ice_milk	rdfs:subClassOf	cn:frozen_dessert
cn:cucmber	rdfs:subClassOf	cn:vegetable
cn:douhua	rdfs:subClassOf	cn:food
cn:custard	cn:instanceOf	cn:dessert
cn:semolina_pudding	rdfs:subClassOf	cn:food
cn:plant	rdfs:subClassOf	cn:organism
cn:biangbiang_noodles	rdfs:subClassOf	cn:food
cn:xiaolongbao	rdfs:subClassOf	cn:food
cn:fisherman's_soup	cn:instanceOf	cn:soup
cn:jambalaya	rdfs:subClassOf	cn:dish
cn:goulash	rdfs:subClassOf	cn:food
cn:jalebi	rdfs:subClassOf	cn:food
cn:rice	rdfs:subClassOf	cn:starches
cn:pemmican	rdfs:subClassOf	cn:meat
cn:amanita	rdfs:subClassOf	cn:fungus
cn:pholiota_squarrosoides	rdfs:subClassOf	cn:agaric
cn:tortilla	cn:usedFor	cn:make_taco
cn:tomato	rdfs:subClassOf	cn:vegetable
cn:beef	rdfs:subClassOf	cn:meat
cn:whipped_cream	rdfs:subClassOf	cn:food
cn:bread_crumbs	rdfs:subClassOf	cn:food
cn:emping	rdfs:subClassOf	cn:food
cn:penicillium	rdfs:subClassOf	cn:fungus
cn:quandong	rdfs:subClassOf	cn:fruit
cn:potoato	rdfs:subClassOf	cn:food
cn:meat	cn:usedFor	cn:abstaining_from
cn:tortilla	cn:usedFor	cn:making_taco
cn:loaf_of_bread	rdfs:subClassOf	cn:ready_to_eat_food
cn:corn	rdfs:subClassOf	cn:food
cn:food	rdfs:subClassOf	cn:foundation_for_health
cn:pasta_bowl	rdfs:subClassOf	cn:dish
cn:strawberry	rdfs:subClassOf	cn:edible_fruit
cn:mozzarella_cheese	rdfs:subClassOf	cn:cheese
cn:biriani	rdfs:subClassOf	cn:dish
cn:boule	rdfs:subClassOf	cn:food
cn:euphonious	cn:similarTo	cn:golden
cn:baseball_field	cn:hasProperty	cn:green
cn:affogato	rdfs:subClassOf	cn:food
cn:steak_and_kidney_pie	rdfs:subClassOf	cn:food
cn:meat	cn:usedFor	cn:sale
cn:gastrocybe_lateritia	rdfs:subClassOf	cn:fungus
cn:mould	rdfs:subClassOf	cn:dessert
cn:bomb	rdfs:subClassOf	cn:object
cn:watches	cn:hasProperty	cn:solid
cn:cottage_cheese	rdfs:subClassOf	cn:cheese
cn:cannelloni	rdfs:subClassOf	cn:food
cn:slug	rdfs:subClassOf	cn:food
cn:mexican_state	rdfs:subClassOf	cn:state
cn:kidney_pie	rdfs:subClassOf	cn:meat_pie
cn:fungus	rdfs:subClassOf	cn:fungus
cn:aqua	rdfs:subClassOf	cn:color
cn:cepelinai	rdfs:subClassOf	cn:food
cn:euascomycetes	rdfs:subClassOf	cn:fungus
cn:okroshka	rdfs:subClassOf	cn:food
cn:churro	rdfs:subClassOf	cn:food
cn:pizza	cn:hasProperty	cn:baked_in_oven
cn:tarator	rdfs:subClassOf	cn:food
cn:bananas	cn:hasProperty	cn:yellow
cn:glass	cn:hasProperty	cn:green
cn:sandwich	cn:partOf	cn:meal
cn:parmelia	rdfs:subClassOf	cn:fungus
cn:vegetables	cn:hasProperty	cn:very_good_for
cn:radish	rdfs:subClassOf	cn:vegetable
cn:trumpet	cn:hasProperty	cn:solid
cn:bamboo	rdfs:subClassOf	cn:solid
cn:kosher_deli	cn:usedFor	cn:sandwich
cn:cinnabar_chanterelle	rdfs:subClassOf	cn:agaric
cn:bratwurst	cn:instanceOf	cn:sausage
cn:crispbread	rdfs:subClassOf	cn:food
cn:we	cn:capableOf	cn:state
cn:cinnamon_bread	rdfs:subClassOf	cn:bread
cn:bay_leaf	rdfs:subClassOf	cn:leaf
cn:mucor	rdfs:subClassOf	cn:fungus
cn:african_oil_palm_fruit	rdfs:subClassOf	cn:fruit
cn:saute	rdfs:subClassOf	cn:dish
cn:living	cn:hasPrerequisite	cn:food
cn:soy_sauce	rdfs:subClassOf	cn:liquid
cn:wholemeal_bread	rdfs:subClassOf	cn:bread
cn:fruit	cn:usedFor	cn:eat
cn:whole_body	rdfs:subClassOf	cn:living_thing
cn:bread	cn:hasA	cn:yeast
cn:dependency_inversion_principle	rdfs:subClassOf	cn:solid
cn:english_muffin	rdfs:subClassOf	cn:bread
cn:coconut	rdfs:subClassOf	cn:fruit
cn:fruit	cn:usedFor	cn:consumption
cn:soba	rdfs:subClassOf	cn:food
cn:yellow	cn:similarTo	cn:dishonorable
cn:grass	rdfs:subClassOf	cn:living_thing
cn:cheese	cn:madeOf	cn:fermented_milk_and_bacteria
cn:apples	cn:hasProperty	cn:green
cn:paper	rdfs:subClassOf	cn:solid
cn:inky_cap	rdfs:subClassOf	cn:agaric
cn:virus	rdfs:subClassOf	cn:organism
cn:ketchup	rdfs:subClassOf	cn:food
cn:pholiota_destruens	rdfs:subClassOf	cn:agaric
cn:food	cn:receivesAction	cn:purchased_in_pizzeria
cn:eye_color	rdfs:subClassOf	cn:color
cn:dish	cn:usedFor	cn:carrying_food
cn:food	cn:capableOf	cn:elevate_one's_mood
cn:bread	rdfs:subClassOf	cn:baked_food
cn:boiled_dinner	rdfs:subClassOf	cn:dish
cn:lemon	rdfs:subClassOf	cn:living_thing
cn:eating_quickly	cn:hasPrerequisite	cn:soup
cn:viridian_thing	rdfs:subClassOf	cn:green
cn:trichocomaceae	rdfs:subClassOf	cn:fungus
cn:chocolate_cake	rdfs:subClassOf	cn:food
cn:half	cn:partOf	cn:whole
cn:chili_con_carne	rdfs:subClassOf	cn:food
cn:carpeting	cn:usedFor	cn:decoration
cn:cruciferous_vegetable	rdfs:subClassOf	cn:vegetable
cn:black_root_rot_fungus	rdfs:subClassOf	cn:fungus
cn:orange	rdfs:subClassOf	cn:color
cn:stuffed_tomato	rdfs:subClassOf	cn:dish
cn:garden_strawberry	rdfs:subClassOf	cn:strawberry
cn:tortilla	cn:definedAs	cn:substrate_for_tostada
cn:sausage_meat	rdfs:subClassOf	cn:meat
cn:fruit	cn:hasA	cn:antioxidants
cn:satisfying_appetites_with_minimum_effort	cn:usedFor	cn:soup
cn:bread	cn:receivesAction	cn:cut_with_knife
cn:cook_meal	cn:motivatedByGoal	cn:food
cn:cracker	rdfs:subClassOf	cn:snack_food
cn:veal	rdfs:subClassOf	cn:meat
cn:can_of_soda	rdfs:subClassOf	cn:food
cn:aggregate_fruit	rdfs:subClassOf	cn:fruit
cn:tourtiere	rdfs:subClassOf	cn:meat_pie
cn:jelly_fungus	rdfs:subClassOf	cn:fungus
cn:wedding_cake	rdfs:subClassOf	cn:food
cn:state	rdfs:subClassOf	cn:unnatural_thing
cn:fruit	cn:hasA	cn:seeds
cn:julienne	rdfs:subClassOf	cn:soup
cn:turkey_flesh	rdfs:subClassOf	cn:meat
cn:steak	rdfs:subClassOf	cn:meat
cn:cheese	cn:receivesAction	cn:eaten
cn:hash	rdfs:subClassOf	cn:dish
cn:wait_on_line	cn:motivatedByGoal	cn:hamburger
cn:tahini	rdfs:subClassOf	cn:food
cn:lamington	rdfs:subClassOf	cn:food
cn:state_in_liberia	rdfs:subClassOf	cn:state
cn:meat	cn:usedFor	cn:protein
cn:seed	rdfs:subClassOf	cn:object
cn:hygrophoraceae	rdfs:subClassOf	cn:fungus
cn:fried_rice	rdfs:subClassOf	cn:dish
cn:pickle	rdfs:subClassOf	cn:food
cn:staphylococcus	rdfs:subClassOf	cn:living_thing
cn:onion_stem	rdfs:subClassOf	cn:lepiota
cn:sharpness	rdfs:subClassOf	cn:shape
cn:frozen_yogurt	rdfs:subClassOf	cn:food
cn:kansas	rdfs:subClassOf	cn:state
cn:zeppole	rdfs:subClassOf	cn:food
cn:hamburger	rdfs:subClassOf	cn:food
cn:mince	rdfs:subClassOf	cn:nutriment
cn:hot_and_sour_soup	cn:instanceOf	cn:soup
cn:gymnopilus_ventricosus	rdfs:subClassOf	cn:agaric
cn:seafood	rdfs:subClassOf	cn:food
cn:cookie	rdfs:subClassOf	cn:food
cn:stodge	rdfs:subClassOf	cn:nutriment
cn:mandu	rdfs:subClassOf	cn:food
cn:garden	cn:usedFor	cn:decoration
cn:t_bone_steak	rdfs:subClassOf	cn:food
cn:vinyl	cn:usedFor	cn:produce
cn:orange	rdfs:subClassOf	cn:fruit
cn:guacamole	rdfs:subClassOf	cn:green
cn:quince_cheese	rdfs:subClassOf	cn:food
cn:seafood_newburg	rdfs:subClassOf	cn:dish
cn:religieuse	cn:instanceOf	cn:dessert
cn:fruit	cn:usedFor	cn:eating
cn:dhokla	rdfs:subClassOf	cn:food
cn:great_britain	rdfs:subClassOf	cn:state
cn:creating_art	cn:usedFor	cn:decoration
cn:candle	cn:usedFor	cn:decoration
cn:pinkness	rdfs:subClassOf	cn:pink
cn:water	cn:hasProperty	cn:liquid
cn:muscle	rdfs:subClassOf	cn:meat
cn:matzo	rdfs:subClassOf	cn:food
cn:pod	rdfs:subClassOf	cn:fruit
cn:tomatoes	rdfs:subClassOf	cn:food
cn:malted_milk	rdfs:subClassOf	cn:ingredient
cn:open_closed_principle	rdfs:subClassOf	cn:solid
cn:pretzel	cn:instanceOf	cn:bread
cn:english_muffin	cn:instanceOf	cn:bread
cn:tortilla	rdfs:subClassOf	cn:structural_element_in_taco
cn:commune	rdfs:subClassOf	cn:state
cn:spam	rdfs:subClassOf	cn:food
cn:organism	cn:desires	cn:live
cn:meat	rdfs:subClassOf	cn:inanimate_object
cn:color	cn:hasA	cn:different_temperatures
cn:sausage	rdfs:subClassOf	cn:foodstuff
cn:paxillus	rdfs:subClassOf	cn:fungus
cn:cheesecake	rdfs:subClassOf	cn:food
cn:ascochyta	rdfs:subClassOf	cn:fungus
cn:acorn	rdfs:subClassOf	cn:fruit
cn:risotto	rdfs:subClassOf	cn:dish
cn:slice_of_bread	rdfs:subClassOf	cn:bread
cn:cell	rdfs:subClassOf	cn:living_thing
cn:agaricus_campestris	rdfs:subClassOf	cn:fungus
cn:sandy_mushroom	rdfs:subClassOf	cn:agaric
cn:pit	cn:partOf	cn:peach
cn:fillet	rdfs:subClassOf	cn:meat
cn:ciabatta	rdfs:subClassOf	cn:food
cn:tv_sets	cn:hasProperty	cn:solid
cn:cheese	cn:hasA	cn:lot_of_fat
cn:brocolli	rdfs:subClassOf	cn:vegetable
cn:hamburger	rdfs:subClassOf	cn:ground_meat
cn:applesauce	rdfs:subClassOf	cn:dish
cn:green	rdfs:subClassOf	cn:chromatic_color
cn:coil	rdfs:subClassOf	cn:shape
cn:colorado	rdfs:subClassOf	cn:state
cn:scotch_broth	rdfs:subClassOf	cn:soup
cn:babka	rdfs:subClassOf	cn:food
cn:chocolate	cn:capableOf	cn:melts
cn:musakhan	rdfs:subClassOf	cn:food
cn:hamburger	rdfs:subClassOf	cn:burger
cn:cheese	cn:madeOf	cn:milk
cn:lepiota_naucina	rdfs:subClassOf	cn:lepiota
cn:sandwich	rdfs:subClassOf	cn:finger_food
cn:feta_cheese	rdfs:subClassOf	cn:cheese
cn:jewelry	cn:usedFor	cn:decoration
cn:fusilli	rdfs:subClassOf	cn:food
cn:food	cn:receivesAction	cn:eaten_from_dish
cn:fraction	cn:partOf	cn:whole
cn:serrate_leaf	rdfs:subClassOf	cn:leaf
cn:graham_bread	cn:instanceOf	cn:bread
cn:oden	rdfs:subClassOf	cn:food
cn:bavarian_cream	cn:instanceOf	cn:dessert
cn:contortionion	rdfs:subClassOf	cn:living_thing
cn:color	cn:hasA	cn:wave_lengths
cn:tulumba	rdfs:subClassOf	cn:food
cn:soup	rdfs:subClassOf	cn:food_item
cn:texas	rdfs:subClassOf	cn:state
cn:nevada	rdfs:subClassOf	cn:state
cn:liquid	cn:similarTo	cn:gas
cn:wheel	cn:hasProperty	cn:circular
cn:vegetables	cn:receivesAction	cn:grown_in_own_garden
cn:frond	rdfs:subClassOf	cn:leaf
cn:candida_glabrata	rdfs:subClassOf	cn:fungus
cn:roll	rdfs:subClassOf	cn:bread
cn:chlorophyllum_molybdites	rdfs:subClassOf	cn:fungus
cn:khinkali	rdfs:subClassOf	cn:food
cn:watery	cn:similarTo	cn:liquid
cn:legume	rdfs:subClassOf	cn:vegetable
cn:cheese	cn:hasA	cn:strong_odor
cn:glomeromycota	rdfs:subClassOf	cn:fungus
cn:following_recipe	cn:causes	cn:dish
cn:fish	rdfs:subClassOf	cn:meat
cn:madeleine	rdfs:subClassOf	cn:food
cn:banana_split	rdfs:subClassOf	cn:food
cn:chocolate	cn:receivesAction	cn:eaten
cn:color	rdfs:subClassOf	cn:appearance
cn:brie	rdfs:subClassOf	cn:cheese
cn:coffee_cherry	rdfs:subClassOf	cn:fruit
cn:pretzel	rdfs:subClassOf	cn:food
cn:soap	cn:capableOf	cn:liquid
cn:skirt_steak	rdfs:subClassOf	cn:food
cn:congenital_thing	rdfs:subClassOf	cn:living_thing
cn:naengmyeon	cn:instanceOf	cn:soup
cn:hygrophorus	rdfs:subClassOf	cn:fungus
cn:stropharia_rugoso_annulata	rdfs:subClassOf	cn:agaric
cn:making_bread	cn:causes	cn:bread
cn:bathing_cap	rdfs:subClassOf	cn:cap
cn:eat_hamburger	cn:motivatedByGoal	cn:food
cn:celebrating	cn:hasPrerequisite	cn:food
cn:entoloma_aprile	rdfs:subClassOf	cn:agaric
cn:plate	cn:usedFor	cn:decoration
cn:seed	rdfs:subClassOf	cn:fruit
cn:worthless_object	rdfs:subClassOf	cn:object
cn:go_to_pub	cn:motivatedByGoal	cn:food
cn:stew_meat	rdfs:subClassOf	cn:meat
cn:dutch_elm_fungus	rdfs:subClassOf	cn:fungus
cn:yellowish_pink	rdfs:subClassOf	cn:pink
cn:butter	rdfs:subClassOf	cn:food
cn:green	rdfs:subClassOf	cn:site
cn:bomber	rdfs:subClassOf	cn:sandwich
cn:sambar	rdfs:subClassOf	cn:food
cn:histoplasma_capsulatum	rdfs:subClassOf	cn:fungus
cn:dolmas	rdfs:subClassOf	cn:dish
cn:fruit	rdfs:subClassOf	cn:best_when_ripe
cn:romesco	rdfs:subClassOf	cn:food
cn:mousse	rdfs:subClassOf	cn:dessert
cn:margarine	rdfs:subClassOf	cn:food
cn:welfare_state	rdfs:subClassOf	cn:state
cn:sweet_potato	rdfs:subClassOf	cn:vegetable
cn:lime	rdfs:subClassOf	cn:living_thing
cn:liquid	cn:similarTo	cn:runny
cn:one_flavor_of_cake	cn:hasProperty	cn:chocolate
cn:bread	cn:hasProperty	cn:white
cn:cottage_pink	rdfs:subClassOf	cn:pink
cn:flowers	cn:hasProperty	cn:green
cn:teacup	rdfs:subClassOf	cn:dish
cn:peach	rdfs:subClassOf	cn:fruit
cn:white	rdfs:subClassOf	cn:color
cn:shchi	rdfs:subClassOf	cn:food
cn:pineapple	rdfs:subClassOf	cn:living_thing
cn:living_thing	rdfs:subClassOf	cn:naturally_occurring_tangible_substance
cn:chorizo	rdfs:subClassOf	cn:food
cn:cheese	rdfs:subClassOf	cn:thing
cn:cucumber	rdfs:subClassOf	cn:edible_fruit
cn:tanning_lotion	cn:hasProperty	cn:liquid
cn:breadstick	rdfs:subClassOf	cn:bread
cn:egg_roll	rdfs:subClassOf	cn:dish
cn:vegetable	cn:partOf	cn:herb
cn:falafel	rdfs:subClassOf	cn:dish
cn:hamburger	cn:similarTo	cn:soyburger
cn:blue	rdfs:subClassOf	cn:color
cn:musical	cn:similarTo	cn:liquid
cn:bun	rdfs:subClassOf	cn:bread
cn:edam	rdfs:subClassOf	cn:cheese
cn:lithuanian_state	rdfs:subClassOf	cn:state
cn:milk	rdfs:subClassOf	cn:liquid
cn:agaricomycetes	rdfs:subClassOf	cn:fungus
cn:bowl	cn:usedFor	cn:soup
cn:potato_pancake	rdfs:subClassOf	cn:food
cn:beanbag_chair	cn:usedFor	cn:decoration
cn:snack_food	rdfs:subClassOf	cn:dish
cn:pizza	rdfs:subClassOf	cn:main_course
cn:siu_mei	rdfs:subClassOf	cn:food
cn:club_fungus	rdfs:subClassOf	cn:fungus
cn:macaron	rdfs:subClassOf	cn:food
cn:potage	rdfs:subClassOf	cn:soup
cn:bhajji	rdfs:subClassOf	cn:food
cn:fruitcake	rdfs:subClassOf	cn:food
cn:timbits	rdfs:subClassOf	cn:food
cn:akutaq	cn:instanceOf	cn:dessert
cn:pretzel	rdfs:subClassOf	cn:snack_food
cn:fringed_pink	rdfs:subClassOf	cn:pink
cn:torulaspora_delbrueckii	rdfs:subClassOf	cn:fungus
cn:fruit	rdfs:subClassOf	cn:also
cn:taco_bell	cn:dbpedia/product	cn:burrito
cn:hamburger	cn:similarTo	cn:lamb_burger
cn:cortinarius_violaceus	rdfs:subClassOf	cn:fungus
cn:dish	cn:usedFor	cn:eating_from
cn:entree	rdfs:subClassOf	cn:course
cn:beignet	rdfs:subClassOf	cn:food
cn:pink	rdfs:subClassOf	cn:very_light_red
cn:fruit	rdfs:subClassOf	cn:good_source_of_vitamins
cn:raw_vegetable	rdfs:subClassOf	cn:vegetable
cn:pumpkin	rdfs:subClassOf	cn:vegetable
cn:wheeled_vehicle	cn:capableOf	cn:roll
cn:fish_loaf	rdfs:subClassOf	cn:meat_loaf
cn:leaf	cn:madeOf	cn:chlorophyll
cn:phallales	rdfs:subClassOf	cn:fungus
cn:white_chocolate	cn:instanceOf	cn:chocolate
cn:solyanka	cn:instanceOf	cn:soup
cn:arroz_con_pollo	rdfs:subClassOf	cn:food
cn:rust	rdfs:subClassOf	cn:fungus
cn:shirred_egg	rdfs:subClassOf	cn:dish
cn:matter	cn:receivesAction	cn:affected_by_electrical_charge
cn:frozen_custard	rdfs:subClassOf	cn:frozen_dessert
cn:rickenella	rdfs:subClassOf	cn:fungus
cn:food	cn:capableOf	cn:become_moldy
cn:plum	rdfs:subClassOf	cn:fruit
cn:cracker	rdfs:subClassOf	cn:bread
cn:cake	cn:instanceOf	cn:dessert
cn:terrine	rdfs:subClassOf	cn:dish
cn:object	cn:receivesAction	cn:moved_in_downward_direction
cn:wine_glass	rdfs:subClassOf	cn:dish
cn:ice_cream_sandwich	rdfs:subClassOf	cn:food
cn:crops	rdfs:subClassOf	cn:vegetables
cn:wine	rdfs:subClassOf	cn:food
cn:grit	rdfs:subClassOf	cn:food
cn:bread	cn:capableOf	cn:rise_overnight
cn:green	cn:madeOf	cn:blue_and_yello
cn:skin_of_bananas	cn:hasProperty	cn:yellow
cn:breakfast_sandwich	rdfs:subClassOf	cn:sandwich
cn:dish	cn:usedFor	cn:eating_off
cn:straightness	rdfs:subClassOf	cn:shape
cn:polypore	rdfs:subClassOf	cn:basidiomycete
cn:bourbon_biscuit	rdfs:subClassOf	cn:food
cn:puff_pastry	rdfs:subClassOf	cn:food
cn:vegetables	cn:receivesAction	cn:cooked
cn:steak_tartare	rdfs:subClassOf	cn:dish
cn:object	rdfs:subClassOf	cn:thing
cn:blastomycete	rdfs:subClassOf	cn:fungus
cn:leeks	rdfs:subClassOf	cn:vegetables
cn:cellophane_noodles	rdfs:subClassOf	cn:food
cn:body	cn:usedFor	cn:food
cn:cucumbers	rdfs:subClassOf	cn:vegetables
cn:historic_scottish_county	rdfs:subClassOf	cn:state
cn:food	cn:hasProperty	cn:unhealthy
cn:mineral	rdfs:subClassOf	cn:matter
cn:saccharomyces_boulardii	rdfs:subClassOf	cn:fungus
cn:matsutake	rdfs:subClassOf	cn:fungus
cn:healthy_grass	cn:hasProperty	cn:green
cn:cantharellopsis	rdfs:subClassOf	cn:fungus
cn:stracchino	rdfs:subClassOf	cn:cheese
cn:salami	rdfs:subClassOf	cn:sausage
cn:stuffed_cabbage	rdfs:subClassOf	cn:dish
cn:salmon	rdfs:subClassOf	cn:food
cn:carrots	cn:hasProperty	cn:vegetables
cn:brown	rdfs:subClassOf	cn:color
cn:clover	cn:hasProperty	cn:green
cn:compound_fruit	rdfs:subClassOf	cn:fruit
cn:sausage	cn:similarTo	cn:haggis
cn:burrito	rdfs:subClassOf	cn:food
cn:swollen_thing	rdfs:subClassOf	cn:living_thing
cn:hen_of_woods	rdfs:subClassOf	cn:fungus
cn:lettuce	rdfs:subClassOf	cn:leafy_vegetable
cn:meat	rdfs:subClassOf	cn:form_of_food
cn:sausage	cn:similarTo	cn:toad_in_hole
cn:blusher	rdfs:subClassOf	cn:fungus
cn:turnover	rdfs:subClassOf	cn:dish
cn:cheese	cn:receivesAction	cn:made_from_milk
cn:volvariella_volvacea	rdfs:subClassOf	cn:fungus
cn:cereal_grain	rdfs:subClassOf	cn:fruit
cn:soup	cn:receivesAction	cn:served_in_bowl
cn:rhizopus	rdfs:subClassOf	cn:fungus
cn:simple_leaf	rdfs:subClassOf	cn:leaf
cn:russulales	rdfs:subClassOf	cn:fungus
cn:boiled_egg	rdfs:subClassOf	cn:dish
cn:snack_food	rdfs:subClassOf	cn:food_item
cn:maryland	rdfs:subClassOf	cn:state
cn:cos	rdfs:subClassOf	cn:lettuce
cn:agaric	rdfs:subClassOf	cn:basidiomycete
cn:pear	cn:hasProperty	cn:solid
cn:tricholoma	rdfs:subClassOf	cn:fungus
cn:food	rdfs:subClassOf	cn:nourishment
cn:bread	cn:usedFor	cn:pudding
cn:chromatic_color	rdfs:subClassOf	cn:color
cn:meat	cn:receivesAction	cn:taken_from_freshly_killed_animals
cn:leaf	cn:usedFor	cn:shade
cn:bannock	rdfs:subClassOf	cn:food
cn:café_au_lait	rdfs:subClassOf	cn:food
cn:side_dish	rdfs:subClassOf	cn:dish
cn:risotto	rdfs:subClassOf	cn:food
cn:chicken	rdfs:subClassOf	cn:food
cn:lettuce	rdfs:subClassOf	cn:food
cn:gyro	cn:instanceOf	cn:meat
cn:bread	cn:hasProperty	cn:nice_to_eat
cn:tnt	rdfs:subClassOf	cn:yellow
cn:meat	cn:hasProperty	cn:shaped_as_cubes
cn:gefilte_fish	rdfs:subClassOf	cn:dish
cn:ambrosia_apple	rdfs:subClassOf	cn:fruit
cn:vegetables	rdfs:subClassOf	cn:commonly
cn:pseudevernia_furfuracea	rdfs:subClassOf	cn:fungus
cn:black_soup	rdfs:subClassOf	cn:food
cn:frozen_dessert	rdfs:subClassOf	cn:dessert
cn:knackwurst	rdfs:subClassOf	cn:sausage
cn:cabbage	cn:capableOf	cn:help_fight_cancer
cn:tostada	rdfs:subClassOf	cn:tortilla
cn:coffee	rdfs:subClassOf	cn:liquid
cn:dish	cn:usedFor	cn:eat_food_with
cn:kefir	rdfs:subClassOf	cn:food
cn:chicken_soup	rdfs:subClassOf	cn:soup
cn:matter	cn:hasProperty	cn:solid
cn:stew	rdfs:subClassOf	cn:soup
cn:goat_cheese	rdfs:subClassOf	cn:cheese
cn:olive_tree_agaric	rdfs:subClassOf	cn:agaric
cn:commonwealth	cn:similarTo	cn:state
cn:cracker	rdfs:subClassOf	cn:food
cn:beard_skinny	rdfs:subClassOf	cn:living_thing
cn:paska	cn:instanceOf	cn:bread
cn:harp	cn:hasProperty	cn:solid
cn:mottle	rdfs:subClassOf	cn:color
cn:one_possible_product_of_gardening	cn:capableOf	cn:vegetables
cn:painting	cn:usedFor	cn:decoration
cn:cheese_pizza	rdfs:subClassOf	cn:pizza
cn:food	rdfs:subClassOf	cn:grocery
cn:color	rdfs:subClassOf	cn:timbre
cn:hamburger	cn:similarTo	cn:vegeburger
cn:canned_food	rdfs:subClassOf	cn:foodstuff
cn:oranges_and_apples	rdfs:subClassOf	cn:fruit
cn:chocolate_candy	rdfs:subClassOf	cn:chocolate
cn:brown_bread	rdfs:subClassOf	cn:food
cn:gazpacho	rdfs:subClassOf	cn:food
cn:dish	rdfs:subClassOf	cn:nutriment
cn:coloration	rdfs:subClassOf	cn:color
cn:white_fungus	rdfs:subClassOf	cn:fungus
cn:cumquat	rdfs:subClassOf	cn:fruit
cn:sailor_cap	rdfs:subClassOf	cn:cap
cn:brunei	rdfs:subClassOf	cn:state
cn:leaf_shape	cn:partOf	cn:leaf
cn:nigerian_state	rdfs:subClassOf	cn:state
cn:food	cn:usedFor	cn:nourishment
cn:mauve	rdfs:subClassOf	cn:color
cn:fruit	cn:createdBy	cn:plant
cn:handle	cn:partOf	cn:object
cn:health_food	rdfs:subClassOf	cn:food
cn:potatoes	rdfs:subClassOf	cn:food
cn:open_bag_of_chips	cn:motivatedByGoal	cn:food
cn:topping	cn:partOf	cn:dish
cn:naan	cn:instanceOf	cn:bread
cn:skullcap	rdfs:subClassOf	cn:cap
cn:brie_cheese	rdfs:subClassOf	cn:cheese
cn:satisfy_appetites_with_minimum_effort	cn:hasPrerequisite	cn:food
cn:béchamel_sauce	rdfs:subClassOf	cn:food
cn:dog	cn:desires	cn:food
cn:matter	rdfs:subClassOf	cn:energy
cn:liquid	cn:hasA	cn:weaker_internal_forces_than_solid
cn:hamburger	rdfs:subClassOf	cn:junk_food
cn:indigo	rdfs:subClassOf	cn:color
cn:blood	cn:hasProperty	cn:liquid
cn:violet	cn:similarTo	cn:purple
cn:food	cn:capableOf	cn:give_nourishment_to_hungry_people
cn:hip	rdfs:subClassOf	cn:fruit
cn:hygrophorus_marzuolus	rdfs:subClassOf	cn:fungus
cn:vegetables	cn:hasProperty	cn:fresh_frozen_or_canned
cn:green	rdfs:subClassOf	cn:secondary_colour
cn:soup	rdfs:subClassOf	cn:commonly
cn:naengmyeon	rdfs:subClassOf	cn:food
cn:dish	rdfs:subClassOf	cn:food_vessel
cn:slatko	rdfs:subClassOf	cn:food
cn:carbonnade_flamande	rdfs:subClassOf	cn:dish
cn:fucker	rdfs:subClassOf	cn:object
cn:pilaf	rdfs:subClassOf	cn:food
cn:anadama_bread	rdfs:subClassOf	cn:bread
cn:cucumber	rdfs:subClassOf	cn:crisp_vegetable
cn:peach	rdfs:subClassOf	cn:fruit_tree
cn:cap	cn:partOf	cn:fungus
cn:characterization	rdfs:subClassOf	cn:living_thing
cn:ingredient	cn:partOf	cn:dish
cn:white_chocolate	rdfs:subClassOf	cn:food
cn:meat	cn:hasProperty	cn:unable_to_eaten_by_rabbits
cn:oval	rdfs:subClassOf	cn:manifold
cn:kig_ha_farz	rdfs:subClassOf	cn:food
cn:wood_decay_fungus	rdfs:subClassOf	cn:fungus
cn:pajeon	rdfs:subClassOf	cn:food
cn:dead_man's_fingers	rdfs:subClassOf	cn:fungus
cn:buttermilk	rdfs:subClassOf	cn:yellow
cn:floating_island	cn:instanceOf	cn:dessert
cn:crenate_leaf	rdfs:subClassOf	cn:leaf
cn:tooth_fungus	rdfs:subClassOf	cn:fungus
cn:hamburger	rdfs:subClassOf	cn:not_seafood
cn:man_on_horse	rdfs:subClassOf	cn:agaric
cn:matter	rdfs:subClassOf	cn:tangible_thing
cn:omelette	rdfs:subClassOf	cn:food
cn:produce	rdfs:subClassOf	cn:produce_market_category
cn:military_officer's_cap	rdfs:subClassOf	cn:cap
cn:cream_cheese	rdfs:subClassOf	cn:cheese
cn:chicken_feet	rdfs:subClassOf	cn:food
cn:pizza	cn:instanceOf	cn:flatbread
cn:earthball	rdfs:subClassOf	cn:fungus
cn:mauve	rdfs:subClassOf	cn:purple
cn:lorchel	rdfs:subClassOf	cn:fungus
cn:legume	rdfs:subClassOf	cn:fruit
cn:small_cap	rdfs:subClassOf	cn:corporation
cn:panna_cotta	rdfs:subClassOf	cn:food
cn:massachusetts	rdfs:subClassOf	cn:state
cn:ice_cream	rdfs:subClassOf	cn:food
cn:iowa	rdfs:subClassOf	cn:state
cn:gyroflexus	rdfs:subClassOf	cn:fungus
cn:jade_green	rdfs:subClassOf	cn:green
cn:meat	cn:hasA	cn:protein
cn:pudding	rdfs:subClassOf	cn:dish
cn:autonomous_community	rdfs:subClassOf	cn:state
cn:greenish_yellow	rdfs:subClassOf	cn:yellow
cn:cullen_skink	cn:instanceOf	cn:soup
cn:solyanka	rdfs:subClassOf	cn:food
cn:meat	cn:capableOf	cn:brown_in_pan
cn:cheese	rdfs:subClassOf	cn:good_protein_food
cn:ice_cream	rdfs:subClassOf	cn:frozen_dessert
cn:parted_leaf	rdfs:subClassOf	cn:leaf
cn:celery	rdfs:subClassOf	cn:vegetable
cn:bread	cn:usedFor	cn:spreading_with_butter
cn:slice	cn:partOf	cn:orange
cn:potatoes	rdfs:subClassOf	cn:vegetable
cn:dessert	rdfs:subClassOf	cn:pleasant_snack_between_meals
cn:flesh	rdfs:subClassOf	cn:color
cn:emerald	rdfs:subClassOf	cn:green
cn:soup	rdfs:subClassOf	cn:food
cn:frozen_liquid	rdfs:subClassOf	cn:solid
cn:bread	cn:receivesAction	cn:made_from_grain
cn:cookies_and_pies	rdfs:subClassOf	cn:food
cn:soap	rdfs:subClassOf	cn:solid
cn:gala_apple	rdfs:subClassOf	cn:fruit
cn:cup	cn:hasA	cn:liquid
cn:karelian_pasty	rdfs:subClassOf	cn:food
cn:amplexicaul_leaf	rdfs:subClassOf	cn:leaf
cn:ice_cream	cn:hasPrerequisite	cn:milk
cn:parallel_veined_leaf	rdfs:subClassOf	cn:leaf
cn:green	cn:partOf	cn:golf_course
cn:hamburger	rdfs:subClassOf	cn:very_fatty_food
cn:teriyaki	rdfs:subClassOf	cn:dish
cn:liquid	cn:hasProperty	cn:clear
cn:ice_cream_sandwich	cn:instanceOf	cn:ice_cream
cn:pieplant	rdfs:subClassOf	cn:vegetable
cn:raw_bananas	cn:hasProperty	cn:green
cn:cream	rdfs:subClassOf	cn:foodstuff
cn:bread	cn:receivesAction	cn:eaten_with_jam
cn:lepiota_clypeolaria	rdfs:subClassOf	cn:fungus
cn:porridge	rdfs:subClassOf	cn:food
cn:food	cn:receivesAction	cn:purchased_at_grocer_shop
cn:cortinarius_atkinsonianus	rdfs:subClassOf	cn:agaric
cn:lamb_meat	rdfs:subClassOf	cn:meat
cn:carbonado	rdfs:subClassOf	cn:meat
cn:meringue	cn:instanceOf	cn:dessert
cn:gasoline	rdfs:subClassOf	cn:liquid
cn:matter	rdfs:subClassOf	cn:anything
cn:gyro	cn:instanceOf	cn:sandwich
cn:cataphyll	rdfs:subClassOf	cn:leaf
cn:strawberry	rdfs:subClassOf	cn:herb
cn:traffic_light	cn:hasProperty	cn:green
cn:ice_cream	rdfs:subClassOf	cn:food_composite
cn:cotylidia	rdfs:subClassOf	cn:fungus
cn:udon	rdfs:subClassOf	cn:food
cn:grated_cheese	rdfs:subClassOf	cn:cheese
cn:consomme	rdfs:subClassOf	cn:soup
cn:metallic_color	rdfs:subClassOf	cn:color
cn:ajika	rdfs:subClassOf	cn:food
cn:cottage_pie	rdfs:subClassOf	cn:dish
cn:cooking_meal	cn:hasPrerequisite	cn:food
cn:ice_milk	cn:instanceOf	cn:dessert
cn:australian_state	rdfs:subClassOf	cn:state
cn:fruit	rdfs:subClassOf	cn:important_food_source
cn:frozen_food	rdfs:subClassOf	cn:foodstuff
cn:bread	cn:receivesAction	cn:eaten
cn:castello_toscana	rdfs:subClassOf	cn:cheese
cn:kissel	rdfs:subClassOf	cn:food
cn:anaerobic_thing	rdfs:subClassOf	cn:living_thing
cn:starches	rdfs:subClassOf	cn:polymers_of_glucose
cn:cheese	cn:capableOf	cn:salad_dressing
cn:miso_soup	cn:instanceOf	cn:soup
cn:gouda_cheese	rdfs:subClassOf	cn:cheese
cn:food	cn:usedFor	cn:have_fight
cn:aerobic_thing	rdfs:subClassOf	cn:living_thing
cn:fourth_of_july_tomato	rdfs:subClassOf	cn:fruit
cn:thuringian_sausage	rdfs:subClassOf	cn:food
cn:cyprus	rdfs:subClassOf	cn:state
cn:pepper_pot	rdfs:subClassOf	cn:soup
cn:green	rdfs:subClassOf	cn:primary_colour
cn:speculoos	rdfs:subClassOf	cn:food
cn:nameko	rdfs:subClassOf	cn:agaric
cn:zongzi	rdfs:subClassOf	cn:food
cn:semicircular	rdfs:subClassOf	cn:circular
cn:milkcap	rdfs:subClassOf	cn:agaric
cn:ice_cream	cn:hasProperty	cn:frozen_sugary_cream
cn:fairy_ring_mushroom	rdfs:subClassOf	cn:agaric
cn:meat_loaf	rdfs:subClassOf	cn:person
cn:enokitake	rdfs:subClassOf	cn:fungus
cn:candy_cap	rdfs:subClassOf	cn:fungus
cn:king_cake	rdfs:subClassOf	cn:food
cn:meat	cn:usedFor	cn:protein_nutrients
cn:bread	rdfs:subClassOf	cn:food
cn:nebraska	rdfs:subClassOf	cn:state
cn:ssamjang	rdfs:subClassOf	cn:food
cn:yellow	cn:definedAs	cn:most_common_color_for_highlighter
cn:christmas_cake	rdfs:subClassOf	cn:food
cn:banbury_cake	rdfs:subClassOf	cn:food
cn:dish	cn:usedFor	cn:eating_food_off_of
cn:alphabet_soup	rdfs:subClassOf	cn:soup
cn:steak_au_poivre	rdfs:subClassOf	cn:dish
cn:banana	rdfs:subClassOf	cn:food
cn:goulash	cn:instanceOf	cn:soup
cn:bread	cn:receivesAction	cn:eaten_with_gravy
cn:lepiota_rhacodes	rdfs:subClassOf	cn:lepiota
cn:trail_mix	rdfs:subClassOf	cn:food
cn:borscht	cn:instanceOf	cn:soup
cn:edible_olive	rdfs:subClassOf	cn:vegetable
cn:chocolate	cn:partOf	cn:cocoa_bean
cn:chicago_deep_dish_pizza	rdfs:subClassOf	cn:pizza
cn:vegetables	cn:hasProperty	cn:eaten_raw_or_cooked
cn:white_chocolate	rdfs:subClassOf	cn:chocolate
cn:chicken_sandwich	rdfs:subClassOf	cn:sandwich
cn:obatzda	rdfs:subClassOf	cn:cheese
cn:semiliquid	cn:similarTo	cn:liquid
cn:tempura	rdfs:subClassOf	cn:dish
cn:dosa	rdfs:subClassOf	cn:food
cn:cubeb	rdfs:subClassOf	cn:fruit
cn:fruit	cn:definedAs	cn:milk_of_mother_earth
cn:swiss_roll	rdfs:subClassOf	cn:food
cn:living_thing	rdfs:subClassOf	cn:finite_spatial_thing
cn:food	cn:madeOf	cn:carbon
cn:animal_or_body_part	rdfs:subClassOf	cn:living_thing
cn:book_end	cn:usedFor	cn:decoration
cn:shape	rdfs:subClassOf	cn:geometric_figure
cn:crouton	rdfs:subClassOf	cn:bread
cn:lecanoraceae	rdfs:subClassOf	cn:fungus
cn:vegetables	cn:capableOf	cn:cook_for_too_long
cn:color	cn:createdBy	cn:neurological_processes
cn:ice_cream_float	rdfs:subClassOf	cn:food
cn:baguette	rdfs:subClassOf	cn:food
cn:ink	rdfs:subClassOf	cn:liquid
cn:go_to_store	cn:motivatedByGoal	cn:ice_cream
cn:california	rdfs:subClassOf	cn:state
cn:milk	rdfs:subClassOf	cn:foodstuff
cn:hymenium	cn:partOf	cn:fungus
cn:edible_fruit	rdfs:subClassOf	cn:fruit
cn:sikhye	rdfs:subClassOf	cn:food
cn:french_fries	rdfs:subClassOf	cn:food
cn:moldovan_state	rdfs:subClassOf	cn:state
cn:chocolate	cn:capableOf	cn:coat_nut
cn:kanafeh	rdfs:subClassOf	cn:food
cn:leaf	cn:definedAs	cn:singular_form_of_leaves
cn:strawberry	rdfs:subClassOf	cn:aggregate_fruit
